Patient,Chromosome,Position,Ref_Base,Variant_Type,Total_Depth,DEL_Count,+_Strand,-_Strand,Allele_Frequency(%)
barcode11,5,70921811,T,DEL,1,1,0,1,100.0
barcode11,5,70921812,T,DEL,1,1,0,1,100.0
barcode11,5,70921862,A,DEL,1,1,0,1,100.0
barcode11,5,70921997,C,DEL,1,1,0,1,100.0
barcode11,5,70924517,T,DEL,2,1,1,0,50.0
barcode11,5,70924525,T,DEL,2,1,1,0,50.0
barcode11,5,70924752,G,DEL,2,1,0,1,50.0
barcode11,5,70924766,G,DEL,2,1,1,0,50.0
barcode11,5,70924860,A,DEL,1162,61,0,61,5.25
barcode11,5,70924864,C,DEL,2026,5,0,5,0.25
barcode11,5,70924865,A,DEL,2158,18,0,18,0.83
barcode11,5,70924866,A,DEL,2188,2,0,2,0.09
barcode11,5,70924867,A,DEL,2250,3,0,3,0.13
barcode11,5,70924868,C,DEL,2300,20,1,19,0.87
barcode11,5,70924869,A,DEL,2363,30,0,30,1.27
barcode11,5,70924870,A,DEL,2374,2,0,2,0.08
barcode11,5,70924871,A,DEL,2383,35,5,30,1.47
barcode11,5,70924872,C,DEL,2393,112,9,103,4.68
barcode11,5,70924873,A,DEL,2406,626,73,553,26.02
barcode11,5,70924874,A,DEL,2422,273,15,258,11.27
barcode11,5,70924875,A,DEL,2432,108,1,107,4.44
barcode11,5,70924876,A,DEL,2437,26,0,26,1.07
barcode11,5,70924877,A,DEL,2444,19,0,19,0.78
barcode11,5,70924878,A,DEL,2459,5,0,5,0.2
barcode11,5,70924879,A,DEL,2487,2,0,2,0.08
barcode11,5,70924880,A,DEL,2499,1,0,1,0.04
barcode11,5,70924881,A,DEL,2505,5,2,3,0.2
barcode11,5,70924882,A,DEL,2514,6,2,4,0.24
barcode11,5,70924883,G,DEL,2522,13,5,8,0.52
barcode11,5,70924884,G,DEL,2544,6,1,5,0.24
barcode11,5,70924885,A,DEL,2579,74,2,72,2.87
barcode11,5,70924888,G,DEL,2612,1,0,1,0.04
barcode11,5,70924889,G,DEL,2634,1,0,1,0.04
barcode11,5,70924890,A,DEL,2658,40,5,35,1.5
barcode11,5,70924891,A,DEL,2665,8,0,8,0.3
barcode11,5,70924892,A,DEL,2673,3,3,0,0.11
barcode11,5,70924893,T,DEL,2675,4,3,1,0.15
barcode11,5,70924894,A,DEL,2744,4,1,3,0.15
barcode11,5,70924895,T,DEL,2749,7,0,7,0.25
barcode11,5,70924896,A,DEL,2792,29,0,29,1.04
barcode11,5,70924898,C,DEL,2937,2,0,2,0.07
barcode11,5,70924899,A,DEL,3210,2,1,1,0.06
barcode11,5,70924902,G,DEL,3345,6,0,6,0.18
barcode11,5,70924903,T,DEL,3351,2,0,2,0.06
barcode11,5,70924904,G,DEL,3373,1,0,1,0.03
barcode11,5,70924905,A,DEL,3403,90,0,90,2.64
barcode11,5,70924908,T,DEL,3455,1,0,1,0.03
barcode11,5,70924909,G,DEL,3480,4,0,4,0.11
barcode11,5,70924910,A,DEL,3562,64,0,64,1.8
barcode11,5,70924911,A,DEL,3584,8,0,8,0.22
barcode11,5,70924913,G,DEL,3594,6,5,1,0.17
barcode11,5,70924914,G,DEL,3602,1,1,0,0.03
barcode11,5,70924915,A,DEL,3650,2,2,0,0.05
barcode11,5,70924916,T,DEL,3655,21,21,0,0.57
barcode11,5,70924917,T,DEL,3661,4,4,0,0.11
barcode11,5,70924918,G,DEL,3694,38,33,5,1.03
barcode11,5,70924919,A,DEL,3786,33,28,5,0.87
barcode11,5,70924920,G,DEL,3816,9,6,3,0.24
barcode11,5,70924921,A,DEL,3856,12,6,6,0.31
barcode11,5,70924922,G,DEL,3872,17,4,13,0.44
barcode11,5,70924923,A,DEL,3886,13,6,7,0.33
barcode11,5,70924924,A,DEL,3915,5,5,0,0.13
barcode11,5,70924927,G,DEL,3918,11,0,11,0.28
barcode11,5,70924928,A,DEL,3970,298,40,258,7.51
barcode11,5,70924929,A,DEL,3989,2,0,2,0.05
barcode11,5,70924931,A,DEL,3998,14,14,0,0.35
barcode11,5,70924932,A,DEL,4004,19,18,1,0.47
barcode11,5,70924933,T,DEL,4013,28,20,8,0.7
barcode11,5,70924935,T,DEL,4081,2,0,2,0.05
barcode11,5,70924936,A,DEL,4155,9,3,6,0.22
barcode11,5,70924937,C,DEL,4187,9,3,6,0.21
barcode11,5,70924938,A,DEL,4204,3,0,3,0.07
barcode11,5,70924939,C,DEL,4219,5,2,3,0.12
barcode11,5,70924940,G,DEL,4257,2,2,0,0.05
barcode11,5,70924941,C,DEL,4291,9,3,6,0.21
barcode11,5,70924942,C,DEL,4293,6,1,5,0.14
barcode11,5,70924943,A,DEL,4320,7,2,5,0.16
barcode11,5,70924944,C,DEL,4327,17,0,17,0.39
barcode11,5,70924945,A,DEL,4306,62,17,45,1.44
barcode11,5,70924946,A,DEL,4332,1,0,1,0.02
barcode11,5,70924947,A,DEL,4342,5,1,4,0.12
barcode11,5,70924948,T,DEL,4343,12,5,7,0.28
barcode11,5,70924949,G,DEL,4383,15,5,10,0.34
barcode11,5,70924950,T,DEL,4404,15,7,8,0.34
barcode11,5,70924951,G,DEL,4426,1096,90,1006,24.76
barcode11,5,70924952,G,DEL,4487,2,0,2,0.04
barcode11,5,70924953,G,DEL,4487,3,1,2,0.07
barcode11,5,70924954,A,DEL,4520,6,2,4,0.13
barcode11,5,70924955,G,DEL,4525,23,7,16,0.51
barcode11,5,70924959,G,DEL,4565,6,0,6,0.13
barcode11,5,70924962,A,DEL,4634,27,0,27,0.58
barcode11,5,70924963,A,DEL,4645,1,0,1,0.02
barcode11,5,70924964,C,DEL,4650,5,3,2,0.11
barcode11,5,70924965,C,DEL,4683,3,0,3,0.06
barcode11,5,70924966,A,DEL,4686,3,0,3,0.06
barcode11,5,70924967,C,DEL,4687,19,1,18,0.41
barcode11,5,70924968,T,DEL,4706,96,0,96,2.04
barcode11,5,70924969,C,DEL,4737,34,0,34,0.72
barcode11,5,70924970,G,DEL,4729,25,2,23,0.53
barcode11,5,70924971,T,DEL,4738,68,2,66,1.44
barcode11,5,70924972,A,DEL,4756,72,23,49,1.51
barcode11,5,70924973,G,DEL,4768,71,16,55,1.49
barcode11,5,70924974,A,DEL,4826,32,2,30,0.66
barcode11,5,70924975,A,DEL,4830,1,0,1,0.02
barcode11,5,70924977,G,DEL,4830,1,1,0,0.02
barcode11,5,70924978,C,DEL,4847,4,4,0,0.08
barcode11,5,70924979,G,DEL,4847,5,2,3,0.1
barcode11,5,70924980,T,DEL,4835,2,2,0,0.04
barcode11,5,70924981,G,DEL,4841,75,64,11,1.55
barcode11,5,70924982,A,DEL,4870,4,1,3,0.08
barcode11,5,70924983,G,DEL,4882,29,16,13,0.59
barcode11,5,70924984,A,DEL,4876,47,30,17,0.96
barcode11,5,70924985,A,DEL,4901,2,2,0,0.04
barcode11,5,70924987,T,DEL,4901,7,6,1,0.14
barcode11,5,70924988,T,DEL,4906,36,35,1,0.73
barcode11,5,70924989,A,DEL,4924,42,41,1,0.85
barcode11,5,70924990,C,DEL,4928,37,36,1,0.75
barcode11,5,70924991,T,DEL,4937,4,1,3,0.08
barcode11,5,70924992,A,DEL,4975,7,3,4,0.14
barcode11,5,70924993,C,DEL,4994,9,3,6,0.18
barcode11,5,70924994,A,DEL,4997,17,10,7,0.34
barcode11,5,70924996,G,DEL,5055,1,0,1,0.02
barcode11,5,70924997,C,DEL,5059,2,1,1,0.04
barcode11,5,70924998,G,DEL,5058,1,1,0,0.02
barcode11,5,70925000,T,DEL,5056,226,1,225,4.47
barcode11,5,70925001,C,DEL,5057,262,6,256,5.18
barcode11,5,70925002,C,DEL,5072,46,2,44,0.91
barcode11,5,70925003,T,DEL,5092,43,5,38,0.84
barcode11,5,70925004,C,DEL,5140,477,338,139,9.28
barcode11,5,70925005,C,DEL,5192,5,1,4,0.1
barcode11,5,70925006,C,DEL,5195,5,4,1,0.1
barcode11,5,70925007,G,DEL,5207,6,6,0,0.12
barcode11,5,70925008,G,DEL,5219,2,2,0,0.04
barcode11,5,70925009,C,DEL,5196,4,2,2,0.08
barcode11,5,70925011,A,DEL,5214,4,3,1,0.08
barcode11,5,70925012,C,DEL,5218,6,6,0,0.11
barcode11,5,70925013,C,DEL,5210,2,1,1,0.04
barcode11,5,70925014,G,DEL,5210,21,3,18,0.4
barcode11,5,70925015,T,DEL,5205,14,1,13,0.27
barcode11,5,70925016,A,DEL,5213,5,1,4,0.1
barcode11,5,70925017,C,DEL,5225,12,9,3,0.23
barcode11,5,70925018,T,DEL,5225,8,0,8,0.15
barcode11,5,70925019,G,DEL,5230,5,1,4,0.1
barcode11,5,70925020,T,DEL,5234,313,14,299,5.98
barcode11,5,70925021,T,DEL,5275,4,0,4,0.08
barcode11,5,70925022,C,DEL,5306,48,10,38,0.9
barcode11,5,70925023,C,DEL,5314,2,1,1,0.04
barcode11,5,70925024,G,DEL,5318,3,2,1,0.06
barcode11,5,70925025,C,DEL,5333,10,4,6,0.19
barcode11,5,70925026,T,DEL,5347,7,6,1,0.13
barcode11,5,70925027,C,DEL,5366,758,711,47,14.13
barcode11,5,70925028,C,DEL,5399,3,1,2,0.06
barcode11,5,70925029,C,DEL,5400,4,2,2,0.07
barcode11,5,70925030,A,DEL,5397,20,11,9,0.37
barcode11,5,70925031,G,DEL,5398,11,3,8,0.2
barcode11,5,70925032,A,DEL,5393,9,2,7,0.17
barcode11,5,70925034,G,DEL,5396,1,1,0,0.02
barcode11,5,70925035,C,DEL,5401,720,512,208,13.33
barcode11,5,70925036,C,DEL,5406,3,2,1,0.06
barcode11,5,70925037,C,DEL,5416,1,1,0,0.02
barcode11,5,70925038,C,DEL,5409,102,97,5,1.89
barcode11,5,70925039,G,DEL,5409,251,166,85,4.64
barcode11,5,70925040,G,DEL,5406,9,8,1,0.17
barcode11,5,70925041,G,DEL,5385,6,5,1,0.11
barcode11,5,70925042,C,DEL,5380,4,4,0,0.07
barcode11,5,70925043,G,DEL,5373,3,1,2,0.06
barcode11,5,70925044,G,DEL,5403,1,1,0,0.02
barcode11,5,70925045,C,DEL,5411,3,2,1,0.06
barcode11,5,70925046,G,DEL,5410,34,28,6,0.63
barcode11,5,70925047,G,DEL,5409,6,1,5,0.11
barcode11,5,70925048,A,DEL,5401,428,8,420,7.92
barcode11,5,70925050,G,DEL,5378,4,3,1,0.07
barcode11,5,70925051,T,DEL,5373,1,0,1,0.02
barcode11,5,70925052,C,DEL,5363,4,2,2,0.07
barcode11,5,70925053,G,DEL,5374,1,1,0,0.02
barcode11,5,70925054,T,DEL,5385,5,0,5,0.09
barcode11,5,70925055,C,DEL,5385,8,0,8,0.15
barcode11,5,70925056,A,DEL,5384,1,1,0,0.02
barcode11,5,70925057,C,DEL,5382,2,0,2,0.04
barcode11,5,70925058,T,DEL,5375,9,7,2,0.17
barcode11,5,70925059,C,DEL,5377,27,10,17,0.5
barcode11,5,70925060,T,DEL,5379,199,91,108,3.7
barcode11,5,70925061,T,DEL,5369,53,1,52,0.99
barcode11,5,70925062,A,DEL,5350,104,14,90,1.94
barcode11,5,70925063,A,DEL,5343,8,5,3,0.15
barcode11,5,70925064,G,DEL,5339,11,6,5,0.21
barcode11,5,70925065,A,DEL,5356,143,86,57,2.67
barcode11,5,70925066,A,DEL,5363,40,37,3,0.75
barcode11,5,70925067,G,DEL,5357,171,124,47,3.19
barcode11,5,70925068,G,DEL,5336,13,11,2,0.24
barcode11,5,70925069,G,DEL,5313,3,3,0,0.06
barcode11,5,70925070,A,DEL,5286,6,5,1,0.11
barcode11,5,70925071,C,DEL,5240,9,6,3,0.17
barcode11,5,70925072,G,DEL,5238,206,162,44,3.93
barcode11,5,70925073,G,DEL,5199,11,5,6,0.21
barcode11,5,70925074,G,DEL,5147,12,11,1,0.23
barcode11,5,70925075,G,DEL,5099,187,185,2,3.67
barcode11,5,70925076,C,DEL,5102,377,351,26,7.39
barcode11,5,70925077,C,DEL,5130,162,149,13,3.16
barcode11,5,70925078,C,DEL,5130,142,138,4,2.77
barcode11,5,70925079,C,DEL,5130,57,50,7,1.11
barcode11,5,70925080,A,DEL,5115,83,74,9,1.62
barcode11,5,70925081,C,DEL,5137,4,3,1,0.08
barcode11,5,70925082,G,DEL,5139,20,18,2,0.39
barcode11,5,70925083,C,DEL,5156,3,0,3,0.06
barcode11,5,70925084,T,DEL,5149,15,2,13,0.29
barcode11,5,70925085,G,DEL,5162,45,38,7,0.87
barcode11,5,70925086,C,DEL,5154,30,27,3,0.58
barcode11,5,70925087,G,DEL,5145,6,4,2,0.12
barcode11,5,70925088,C,DEL,5149,33,8,25,0.64
barcode11,5,70925089,A,DEL,5138,19,17,2,0.37
barcode11,5,70925090,C,DEL,5133,81,73,8,1.58
barcode11,5,70925091,C,DEL,5115,9,8,1,0.18
barcode11,5,70925092,C,DEL,5110,22,21,1,0.43
barcode11,5,70925093,G,DEL,5130,26,26,0,0.51
barcode11,5,70925094,C,DEL,5137,7,3,4,0.14
barcode11,5,70925095,G,DEL,5119,55,9,46,1.07
barcode11,5,70925096,G,DEL,5115,1,1,0,0.02
barcode11,5,70925097,G,DEL,5089,3,3,0,0.06
barcode11,5,70925098,T,DEL,5099,25,20,5,0.49
barcode11,5,70925099,T,DEL,5081,3,3,0,0.06
barcode11,5,70925100,T,DEL,5074,4,4,0,0.08
barcode11,5,70925101,G,DEL,5086,8,8,0,0.16
barcode11,5,70925102,C,DEL,5085,12,8,4,0.24
barcode11,5,70925103,T,DEL,5073,9,4,5,0.18
barcode11,5,70925104,A,DEL,5076,5,4,1,0.1
barcode11,5,70925106,G,DEL,5038,2,0,2,0.04
barcode11,5,70925107,G,DEL,5026,1,0,1,0.02
barcode11,5,70925108,C,DEL,5008,11,0,11,0.22
barcode11,5,70925109,G,DEL,4977,27,0,27,0.54
barcode11,5,70925110,A,DEL,4975,26,0,26,0.52
barcode11,5,70925112,G,DEL,4964,11,3,8,0.22
barcode11,5,70925113,A,DEL,4950,16,5,11,0.32
barcode11,5,70925114,G,DEL,4944,66,2,64,1.33
barcode11,5,70925115,C,DEL,4954,62,0,62,1.25
barcode11,5,70925116,A,DEL,4944,1,1,0,0.02
barcode11,5,70925117,G,DEL,4946,17,5,12,0.34
barcode11,5,70925118,C,DEL,4935,18,5,13,0.36
barcode11,5,70925119,G,DEL,4916,22,8,14,0.45
barcode11,5,70925120,G,DEL,4903,2,1,1,0.04
barcode11,5,70925122,G,DEL,4820,4,2,2,0.08
barcode11,5,70925123,G,DEL,4746,2,2,0,0.04
barcode11,5,70925124,C,DEL,4730,11,3,8,0.23
barcode11,5,70925125,A,DEL,4685,39,36,3,0.83
barcode11,5,70925126,G,DEL,4683,34,33,1,0.73
barcode11,5,70925127,T,DEL,4681,33,32,1,0.7
barcode11,5,70925128,G,DEL,4674,5,3,2,0.11
barcode11,5,70925129,G,DEL,4660,9,6,3,0.19
barcode11,5,70925130,T,DEL,4655,9,7,2,0.19
barcode11,5,70925131,G,DEL,4640,32,30,2,0.69
barcode11,5,70925132,G,DEL,4636,28,28,0,0.6
barcode11,5,70925133,C,DEL,4614,30,29,1,0.65
barcode11,5,70925134,G,DEL,4584,18,4,14,0.39
barcode11,5,70925135,G,DEL,4530,6,6,0,0.13
barcode11,5,70925136,C,DEL,4486,10,9,1,0.22
barcode11,5,70925137,G,DEL,4470,13,9,4,0.29
barcode11,5,70925138,T,DEL,4440,14,14,0,0.32
barcode11,5,70925139,C,DEL,4418,181,166,15,4.1
barcode11,5,70925140,C,DEL,4418,4,0,4,0.09
barcode11,5,70925141,C,DEL,4404,7,5,2,0.16
barcode11,5,70925142,G,DEL,4385,44,28,16,1.0
barcode11,5,70925143,G,DEL,4375,19,6,13,0.43
barcode11,5,70925144,A,DEL,4320,18,15,3,0.42
barcode11,5,70925145,G,DEL,4294,64,28,36,1.49
barcode11,5,70925146,C,DEL,4289,28,19,9,0.65
barcode11,5,70925147,A,DEL,4262,85,84,1,1.99
barcode11,5,70925148,G,DEL,4256,63,62,1,1.48
barcode11,5,70925149,G,DEL,4244,54,53,1,1.27
barcode11,5,70925150,A,DEL,4216,41,39,2,0.97
barcode11,5,70925151,G,DEL,4206,63,62,1,1.5
barcode11,5,70925152,G,DEL,4174,103,103,0,2.47
barcode11,5,70925153,A,DEL,4166,107,107,0,2.57
barcode11,5,70925154,T,DEL,4165,160,147,13,3.84
barcode11,5,70925155,T,DEL,4129,6,0,6,0.15
barcode11,5,70925156,C,DEL,4126,9,2,7,0.22
barcode11,5,70925157,C,DEL,4122,1,0,1,0.02
barcode11,5,70925158,G,DEL,4107,16,0,16,0.39
barcode11,5,70925159,T,DEL,4091,16,0,16,0.39
barcode11,5,70925160,G,DEL,3949,1,0,1,0.03
barcode11,5,70925161,C,DEL,3930,4,4,0,0.1
barcode11,5,70925162,T,DEL,3928,8,0,8,0.2
barcode11,5,70925163,G,DEL,3914,4,1,3,0.1
barcode11,5,70925164,T,DEL,3892,72,66,6,1.85
barcode11,5,70925165,T,DEL,3880,6,5,1,0.15
barcode11,5,70925166,C,DEL,3832,21,9,12,0.55
barcode11,5,70925167,C,DEL,3814,21,6,15,0.55
barcode11,5,70925168,G,DEL,3794,104,20,84,2.74
barcode11,5,70925169,G,DEL,3770,13,13,0,0.34
barcode11,5,70925170,C,DEL,3700,2,2,0,0.05
barcode11,5,70925171,G,DEL,3634,4,4,0,0.11
barcode11,5,70925172,C,DEL,3609,4,3,1,0.11
barcode11,5,70925173,G,DEL,3576,3,2,1,0.08
barcode11,5,70925174,G,DEL,3567,1,1,0,0.03
barcode11,5,70925175,C,DEL,3542,10,9,1,0.28
barcode11,5,70925176,A,DEL,3501,11,11,0,0.31
barcode11,5,70925177,C,DEL,3484,5,4,1,0.14
barcode11,5,70925178,A,DEL,3475,22,21,1,0.63
barcode11,5,70925179,G,DEL,3473,5,4,1,0.14
barcode11,5,70925180,G,DEL,3467,1,1,0,0.03
barcode11,5,70925181,C,DEL,3462,39,39,0,1.13
barcode11,5,70925183,A,DEL,3440,5,4,1,0.15
barcode11,5,70925184,G,DEL,3420,6,2,4,0.18
barcode11,5,70925187,G,DEL,3356,1,1,0,0.03
barcode11,5,70925188,A,DEL,3339,3,1,2,0.09
barcode11,5,70925189,G,DEL,3298,2,1,1,0.06
barcode11,5,70925191,T,DEL,3266,2,1,1,0.06
barcode11,5,70925192,C,DEL,3210,11,10,1,0.34
barcode11,5,70925193,G,DEL,3193,12,10,2,0.38
barcode11,5,70925194,C,DEL,3171,23,0,23,0.73
barcode11,5,70925195,A,DEL,3127,1,0,1,0.03
barcode11,5,70925196,G,DEL,3109,2,2,0,0.06
barcode11,5,70925197,C,DEL,3091,26,25,1,0.84
barcode11,5,70925199,A,DEL,3031,3,3,0,0.1
barcode11,5,70925200,G,DEL,3020,5,4,1,0.17
barcode11,5,70925201,T,DEL,2998,6,2,4,0.2
barcode11,5,70925202,G,DEL,2957,2,2,0,0.07
barcode11,5,70925203,C,DEL,2895,2,2,0,0.07
barcode11,5,70925204,A,DEL,2842,1,1,0,0.04
barcode11,5,70925205,G,DEL,2818,3,3,0,0.11
barcode11,5,70925206,T,DEL,2802,2,2,0,0.07
barcode11,5,70925207,C,DEL,2685,33,3,30,1.23
barcode11,5,70925208,T,DEL,2644,3,1,2,0.11
barcode11,5,70925209,C,DEL,2624,9,8,1,0.34
barcode11,5,70925211,C,DEL,2395,2,2,0,0.08
barcode11,5,70925212,T,DEL,2320,2,2,0,0.09
barcode11,5,70925213,A,DEL,1125,30,30,0,2.67
barcode11,5,70925214,T,DEL,1108,1,1,0,0.09
barcode11,5,70929410,T,DEL,1,1,0,1,100.0
barcode11,5,70929411,T,DEL,1,1,0,1,100.0
barcode11,5,70929412,T,DEL,1,1,0,1,100.0
barcode11,5,70929482,T,DEL,1,1,0,1,100.0
barcode11,5,70938765,C,DEL,1184,2,0,2,0.17
barcode11,5,70938766,T,DEL,1207,3,0,3,0.25
barcode11,5,70938767,C,DEL,1291,23,0,23,1.78
barcode11,5,70938768,T,DEL,1442,92,15,77,6.38
barcode11,5,70938769,T,DEL,1466,1,0,1,0.07
barcode11,5,70938770,G,DEL,1480,6,0,6,0.41
barcode11,5,70938771,G,DEL,1528,1,0,1,0.07
barcode11,5,70938772,T,DEL,1534,22,0,22,1.43
barcode11,5,70938774,C,DEL,1579,8,4,4,0.51
barcode11,5,70938776,A,DEL,1620,12,0,12,0.74
barcode11,5,70938780,T,DEL,1672,1,0,1,0.06
barcode11,5,70938781,A,DEL,1677,18,17,1,1.07
barcode11,5,70938782,C,DEL,1687,3,1,2,0.18
barcode11,5,70938783,A,DEL,1693,15,1,14,0.89
barcode11,5,70938784,T,DEL,1696,75,40,35,4.42
barcode11,5,70938785,T,DEL,1710,11,0,11,0.64
barcode11,5,70938787,T,DEL,1741,9,8,1,0.52
barcode11,5,70938788,C,DEL,1771,24,12,12,1.36
barcode11,5,70938789,T,DEL,1778,9,2,7,0.51
barcode11,5,70938790,G,DEL,1784,31,1,30,1.74
barcode11,5,70938791,A,DEL,1804,1,0,1,0.06
barcode11,5,70938792,T,DEL,1807,3,3,0,0.17
barcode11,5,70938794,A,DEL,1813,54,0,54,2.98
barcode11,5,70938796,A,DEL,1983,1,0,1,0.05
barcode11,5,70938797,C,DEL,1988,1,0,1,0.05
barcode11,5,70938799,T,DEL,2034,7,1,6,0.34
barcode11,5,70938801,T,DEL,2069,10,1,9,0.48
barcode11,5,70938802,C,DEL,2112,1,1,0,0.05
barcode11,5,70938803,T,DEL,2121,3,0,3,0.14
barcode11,5,70938804,G,DEL,2127,61,0,61,2.87
barcode11,5,70938805,A,DEL,2142,101,1,100,4.72
barcode11,5,70938806,A,DEL,2156,2,1,1,0.09
barcode11,5,70938807,C,DEL,2317,2,1,1,0.09
barcode11,5,70938808,A,DEL,2358,8,0,8,0.34
barcode11,5,70938809,T,DEL,2366,3,1,2,0.13
barcode11,5,70938810,G,DEL,2472,5,2,3,0.2
barcode11,5,70938811,A,DEL,2535,1,1,0,0.04
barcode11,5,70938812,G,DEL,2552,2,1,1,0.08
barcode11,5,70938813,T,DEL,2601,2,1,1,0.08
barcode11,5,70938814,T,DEL,2606,8,7,1,0.31
barcode11,5,70938815,G,DEL,2641,12,10,2,0.45
barcode11,5,70938816,T,DEL,2653,295,179,116,11.12
barcode11,5,70938817,T,DEL,2673,105,104,1,3.93
barcode11,5,70938818,T,DEL,2693,11,11,0,0.41
barcode11,5,70938819,T,DEL,2697,14,14,0,0.52
barcode11,5,70938820,T,DEL,2700,17,17,0,0.63
barcode11,5,70938821,A,DEL,2711,21,21,0,0.77
barcode11,5,70938822,T,DEL,2718,22,9,13,0.81
barcode11,5,70938823,T,DEL,2736,10,10,0,0.37
barcode11,5,70938824,T,DEL,2739,11,11,0,0.4
barcode11,5,70938825,C,DEL,2793,14,14,0,0.5
barcode11,5,70938826,T,DEL,2803,53,52,1,1.89
barcode11,5,70938827,T,DEL,2810,4,0,4,0.14
barcode11,5,70938828,A,DEL,2847,19,11,8,0.67
barcode11,5,70938829,C,DEL,2849,67,20,47,2.35
barcode11,5,70938830,C,DEL,2855,1,1,0,0.04
barcode11,5,70938831,C,DEL,2858,6,5,1,0.21
barcode11,5,70938832,T,DEL,2857,67,58,9,2.35
barcode11,5,70938835,C,DEL,2907,14,14,0,0.48
barcode11,5,70938836,C,DEL,2919,2,2,0,0.07
barcode11,5,70938837,A,DEL,2919,16,16,0,0.55
barcode11,5,70938838,G,DEL,2938,4,4,0,0.14
barcode11,5,70938839,A,DEL,2959,5,5,0,0.17
barcode11,5,70938840,G,DEL,2950,1,1,0,0.03
barcode11,5,70938845,G,DEL,2933,1,0,1,0.03
barcode11,5,70938847,T,DEL,2924,20,12,8,0.68
barcode11,5,70938848,T,DEL,2936,15,15,0,0.51
barcode11,5,70938849,C,DEL,2973,21,17,4,0.71
barcode11,5,70938850,T,DEL,2973,3,0,3,0.1
barcode11,5,70938851,G,DEL,2971,39,0,39,1.31
barcode11,5,70938852,A,DEL,2972,6,0,6,0.2
barcode11,5,70938853,C,DEL,2967,1,0,1,0.03
barcode11,5,70938854,A,DEL,2950,1,1,0,0.03
barcode11,5,70938855,T,DEL,2951,23,19,4,0.78
barcode11,5,70938856,T,DEL,2972,1,1,0,0.03
barcode11,5,70938857,T,DEL,2982,4,2,2,0.13
barcode11,5,70938858,G,DEL,2992,135,14,121,4.51
barcode11,5,70938861,A,DEL,2994,2,0,2,0.07
barcode11,5,70938862,T,DEL,2991,1,1,0,0.03
barcode11,5,70938863,G,DEL,2990,2,1,1,0.07
barcode11,5,70938864,A,DEL,3012,14,2,12,0.46
barcode11,5,70938865,T,DEL,2985,14,2,12,0.47
barcode11,5,70938866,A,DEL,3098,7,7,0,0.23
barcode11,5,70938869,G,DEL,3087,15,0,15,0.49
barcode11,5,70938870,C,DEL,3108,1,1,0,0.03
barcode11,5,70938871,A,DEL,3015,2,1,1,0.07
barcode11,5,70938872,C,DEL,3018,4,3,1,0.13
barcode11,5,70938873,T,DEL,3014,7,1,6,0.23
barcode11,5,70938874,G,DEL,2988,5,2,3,0.17
barcode11,5,70938875,A,DEL,2992,4,2,2,0.13
barcode11,5,70938876,T,DEL,2968,3,2,1,0.1
barcode11,5,70938877,A,DEL,2880,112,85,27,3.89
barcode11,5,70938878,A,DEL,2886,3,2,1,0.1
barcode11,5,70938879,A,DEL,2874,2,2,0,0.07
barcode11,5,70938880,A,DEL,2861,3,3,0,0.1
barcode11,5,70938881,G,DEL,2856,3,3,0,0.11
barcode11,5,70938882,C,DEL,2851,2,2,0,0.07
barcode11,5,70938883,A,DEL,2835,2,2,0,0.07
barcode11,5,70938884,T,DEL,2825,3,2,1,0.11
barcode11,5,70938885,A,DEL,2824,4,2,2,0.14
barcode11,5,70938886,T,DEL,2821,1,1,0,0.04
barcode11,5,70938887,G,DEL,2798,1,1,0,0.04
barcode11,5,70938889,T,DEL,2767,1,0,1,0.04
barcode11,5,70938890,A,DEL,2729,11,8,3,0.4
barcode11,5,70938894,C,DEL,2698,1,1,0,0.04
barcode11,5,70938895,T,DEL,2679,1,0,1,0.04
barcode11,5,70938896,G,DEL,2664,3,2,1,0.11
barcode11,5,70938897,T,DEL,2633,3,2,1,0.11
barcode11,5,70938898,G,DEL,2555,6,3,3,0.23
barcode11,5,70938899,G,DEL,2492,2,2,0,0.08
barcode11,5,70938900,C,DEL,2470,8,1,7,0.32
barcode11,5,70938901,T,DEL,2458,21,21,0,0.85
barcode11,5,70938902,T,DEL,2408,3,3,0,0.12
barcode11,5,70938903,C,DEL,2365,3,3,0,0.13
barcode11,5,70938904,A,DEL,2354,4,4,0,0.17
barcode11,5,70938905,T,DEL,2354,23,12,11,0.98
barcode11,5,70938906,T,DEL,2352,2,2,0,0.09
barcode11,5,70938907,T,DEL,2335,3,0,3,0.13
barcode11,5,70938908,A,DEL,2324,38,4,34,1.64
barcode11,5,70938909,A,DEL,2315,5,5,0,0.22
barcode11,5,70938910,G,DEL,2289,3,3,0,0.13
barcode11,5,70938912,T,DEL,2273,4,0,4,0.18
barcode11,5,70938913,A,DEL,2248,12,2,10,0.53
barcode11,5,70938914,T,DEL,2240,1,1,0,0.04
barcode11,5,70938915,G,DEL,2221,5,5,0,0.23
barcode11,5,70938916,A,DEL,2172,16,4,12,0.74
barcode11,5,70938919,T,DEL,2112,52,52,0,2.46
barcode11,5,70938920,G,DEL,2104,52,52,0,2.47
barcode11,5,70938921,C,DEL,2092,52,52,0,2.49
barcode11,5,70938922,T,DEL,2087,58,57,1,2.78
barcode11,5,70938923,T,DEL,2073,6,6,0,0.29
barcode11,5,70938924,G,DEL,2058,21,21,0,1.02
barcode11,5,70938925,C,DEL,2012,15,8,7,0.75
barcode11,5,70938926,T,DEL,2011,11,8,3,0.55
barcode11,5,70938927,T,DEL,1970,4,4,0,0.2
barcode11,5,70938928,A,DEL,1966,3,3,0,0.15
barcode11,5,70938929,G,DEL,1959,7,7,0,0.36
barcode11,5,70938931,C,DEL,1897,5,5,0,0.26
barcode11,5,70938932,G,DEL,1896,4,4,0,0.21
barcode11,5,70938933,T,DEL,1896,86,84,2,4.54
barcode11,5,70938934,T,DEL,1893,4,2,2,0.21
barcode11,5,70938935,T,DEL,1871,6,6,0,0.32
barcode11,5,70938936,T,DEL,1862,8,8,0,0.43
barcode11,5,70938937,C,DEL,1852,11,11,0,0.59
barcode11,5,70938938,T,DEL,1851,2,2,0,0.11
barcode11,5,70938939,T,DEL,1848,1,1,0,0.05
barcode11,5,70938940,A,DEL,1836,2,2,0,0.11
barcode11,5,70938941,T,DEL,1836,187,187,0,10.19
barcode11,5,70938942,T,DEL,1833,1,1,0,0.05
barcode11,5,70938944,T,DEL,1778,14,14,0,0.79
barcode11,5,70938945,C,DEL,1761,16,16,0,0.91
barcode11,5,70941351,A,DEL,42,1,0,1,2.38
barcode11,5,70941355,T,DEL,274,1,0,1,0.36
barcode11,5,70941356,G,DEL,323,2,0,2,0.62
barcode11,5,70941357,T,DEL,575,1,0,1,0.17
barcode11,5,70941358,A,DEL,978,4,0,4,0.41
barcode11,5,70941360,C,DEL,1245,1,1,0,0.08
barcode11,5,70941364,T,DEL,1459,4,0,4,0.27
barcode11,5,70941368,T,DEL,1576,373,11,362,23.67
barcode11,5,70941369,T,DEL,1594,9,0,9,0.56
barcode11,5,70941374,T,DEL,1653,5,4,1,0.3
barcode11,5,70941376,C,DEL,1709,5,0,5,0.29
barcode11,5,70941377,C,DEL,1717,14,0,14,0.82
barcode11,5,70941378,T,DEL,1721,60,2,58,3.49
barcode11,5,70941379,A,DEL,1744,5,3,2,0.29
barcode11,5,70941380,T,DEL,1773,107,25,82,6.03
barcode11,5,70941381,T,DEL,1794,3,0,3,0.17
barcode11,5,70941382,T,DEL,1843,1,0,1,0.05
barcode11,5,70941383,T,DEL,1857,14,0,14,0.75
barcode11,5,70941384,C,DEL,1905,216,0,216,11.34
barcode11,5,70941385,G,DEL,1958,3,1,2,0.15
barcode11,5,70941386,T,DEL,1968,93,1,92,4.73
barcode11,5,70941387,A,DEL,2008,1,1,0,0.05
barcode11,5,70941388,G,DEL,2015,3,0,3,0.15
barcode11,5,70941390,A,DEL,2068,4,4,0,0.19
barcode11,5,70941391,T,DEL,2075,3,1,2,0.14
barcode11,5,70941392,G,DEL,2103,1,0,1,0.05
barcode11,5,70941393,C,DEL,2150,11,6,5,0.51
barcode11,5,70941394,T,DEL,2251,7,3,4,0.31
barcode11,5,70941395,C,DEL,2333,21,13,8,0.9
barcode11,5,70941396,T,DEL,2350,70,0,70,2.98
barcode11,5,70941397,A,DEL,2403,152,0,152,6.33
barcode11,5,70941398,A,DEL,2415,7,0,7,0.29
barcode11,5,70941399,A,DEL,2426,2,1,1,0.08
barcode11,5,70941400,G,DEL,2429,9,1,8,0.37
barcode11,5,70941401,A,DEL,2482,24,23,1,0.97
barcode11,5,70941402,A,DEL,2491,1,0,1,0.04
barcode11,5,70941403,T,DEL,2495,1,0,1,0.04
barcode11,5,70941404,G,DEL,2514,4,1,3,0.16
barcode11,5,70941407,G,DEL,2662,1,0,1,0.04
barcode11,5,70941408,A,DEL,2681,20,0,20,0.75
barcode11,5,70941409,C,DEL,2716,2,1,1,0.07
barcode11,5,70941410,A,DEL,2756,2,1,1,0.07
barcode11,5,70941411,T,DEL,2761,38,28,10,1.38
barcode11,5,70941412,T,DEL,2772,1,0,1,0.04
barcode11,5,70941413,T,DEL,2785,57,55,2,2.05
barcode11,5,70941414,G,DEL,2818,85,84,1,3.02
barcode11,5,70941415,T,DEL,2841,9,7,2,0.32
barcode11,5,70941416,G,DEL,2846,17,4,13,0.6
barcode11,5,70941417,A,DEL,2862,132,29,103,4.61
barcode11,5,70941420,C,DEL,2894,11,0,11,0.38
barcode11,5,70941421,T,DEL,2981,91,91,0,3.05
barcode11,5,70941422,T,DEL,3100,1,1,0,0.03
barcode11,5,70941423,C,DEL,3113,44,40,4,1.41
barcode11,5,70941424,G,DEL,3251,127,2,125,3.91
barcode11,5,70941425,G,DEL,3275,6,0,6,0.18
barcode11,5,70941426,G,DEL,3282,8,0,8,0.24
barcode11,5,70941427,T,DEL,3307,22,0,22,0.67
barcode11,5,70941428,A,DEL,3311,48,6,42,1.45
barcode11,5,70941430,A,DEL,3355,1,0,1,0.03
barcode11,5,70941431,C,DEL,3357,63,52,11,1.88
barcode11,5,70941432,C,DEL,3372,1,0,1,0.03
barcode11,5,70941433,A,DEL,3378,327,67,260,9.68
barcode11,5,70941434,A,DEL,3391,8,4,4,0.24
barcode11,5,70941437,A,DEL,3409,5,1,4,0.15
barcode11,5,70941438,C,DEL,3412,7,3,4,0.21
barcode11,5,70941439,C,DEL,3436,6,4,2,0.17
barcode11,5,70941440,A,DEL,3444,7,3,4,0.2
barcode11,5,70941441,C,DEL,3466,2,1,1,0.06
barcode11,5,70941442,A,DEL,3479,1,0,1,0.03
barcode11,5,70941443,C,DEL,3483,7,1,6,0.2
barcode11,5,70941444,C,DEL,3488,1,0,1,0.03
barcode11,5,70941445,T,DEL,3490,6,0,6,0.17
barcode11,5,70941446,A,DEL,3491,264,63,201,7.56
barcode11,5,70941447,A,DEL,3491,10,5,5,0.29
barcode11,5,70941448,A,DEL,3491,7,5,2,0.2
barcode11,5,70941449,A,DEL,3483,10,5,5,0.29
barcode11,5,70941450,G,DEL,3474,15,6,9,0.43
barcode11,5,70941451,A,DEL,3474,45,10,35,1.3
barcode11,5,70941452,A,DEL,3477,1,0,1,0.03
barcode11,5,70941455,C,DEL,3521,1,1,0,0.03
barcode11,5,70941456,C,DEL,3529,3,3,0,0.09
barcode11,5,70941457,T,DEL,3528,6,4,2,0.17
barcode11,5,70941458,G,DEL,3550,24,24,0,0.68
barcode11,5,70941459,C,DEL,3545,9,4,5,0.25
barcode11,5,70941460,T,DEL,3552,8,4,4,0.23
barcode11,5,70941461,A,DEL,3530,216,168,48,6.12
barcode11,5,70941462,A,DEL,3540,142,113,29,4.01
barcode11,5,70941463,G,DEL,3529,145,114,31,4.11
barcode11,5,70941464,A,DEL,3538,88,87,1,2.49
barcode11,5,70941465,A,DEL,3538,158,153,5,4.47
barcode11,5,70941466,G,DEL,3517,200,195,5,5.69
barcode11,5,70941467,A,DEL,3496,45,33,12,1.29
barcode11,5,70941468,A,DEL,3495,13,0,13,0.37
barcode11,5,70941469,T,DEL,3485,18,1,17,0.52
barcode11,5,70941470,A,DEL,3463,127,56,71,3.67
barcode11,5,70941471,A,DEL,3464,12,0,12,0.35
barcode11,5,70941474,G,DEL,3461,1,1,0,0.03
barcode11,5,70941475,C,DEL,3459,22,18,4,0.64
barcode11,5,70941476,C,DEL,3442,7,2,5,0.2
barcode11,5,70941477,A,DEL,3433,454,111,343,13.22
barcode11,5,70941478,A,DEL,3432,53,7,46,1.54
barcode11,5,70941479,A,DEL,3419,47,39,8,1.37
barcode11,5,70941480,A,DEL,3386,57,39,18,1.68
barcode11,5,70941481,G,DEL,3380,61,40,21,1.8
barcode11,5,70941482,A,DEL,3370,86,7,79,2.55
barcode11,5,70941483,A,DEL,3363,30,28,2,0.89
barcode11,5,70941484,G,DEL,3343,36,34,2,1.08
barcode11,5,70941485,A,DEL,3313,176,153,23,5.31
barcode11,5,70941486,A,DEL,3307,3,3,0,0.09
barcode11,5,70941487,T,DEL,3303,2,2,0,0.06
barcode11,5,70941488,A,DEL,3270,10,7,3,0.31
barcode11,5,70941489,C,DEL,3267,6,6,0,0.18
barcode11,5,70941492,C,DEL,3266,4,1,3,0.12
barcode11,5,70941494,G,DEL,3204,2,1,1,0.06
barcode11,5,70941495,C,DEL,3161,88,1,87,2.78
barcode11,5,70941496,T,DEL,3157,121,115,6,3.83
barcode11,5,70941497,T,DEL,3097,1,1,0,0.03
barcode11,5,70941498,C,DEL,3086,1,1,0,0.03
barcode11,5,70941500,T,DEL,3047,227,227,0,7.45
barcode11,5,70941502,A,DEL,2931,35,35,0,1.19
barcode11,5,70941503,C,DEL,2917,1,1,0,0.03
barcode11,5,70941504,A,DEL,2802,2,1,1,0.07
barcode11,5,70941507,A,DEL,2769,2,2,0,0.07
barcode11,5,70941508,G,DEL,2762,1,1,0,0.04
barcode11,5,70941510,T,DEL,2706,2,1,1,0.07
barcode11,5,70941511,T,DEL,2666,1,0,1,0.04
barcode11,5,70941512,A,DEL,2628,1,0,1,0.04
barcode11,5,70941513,T,DEL,2623,74,68,6,2.82
barcode11,5,70941514,T,DEL,2610,1,0,1,0.04
barcode11,5,70941515,T,DEL,2594,1,0,1,0.04
barcode11,5,70941516,T,DEL,2589,1,0,1,0.04
barcode11,5,70941517,A,DEL,2562,51,39,12,1.99
barcode11,5,70941518,A,DEL,2556,1,0,1,0.04
barcode11,5,70941521,T,DEL,2534,1,1,0,0.04
barcode11,5,70941523,T,DEL,2515,233,233,0,9.26
barcode11,5,70941524,T,DEL,2500,7,7,0,0.28
barcode11,5,70941525,G,DEL,2458,32,30,2,1.3
barcode11,5,70941527,G,DEL,2388,15,15,0,0.63
barcode11,5,70941528,A,DEL,2342,3,3,0,0.13
barcode11,5,70941529,T,DEL,2342,81,81,0,3.46
barcode11,5,70941530,T,DEL,2331,3,3,0,0.13
barcode11,5,70941532,A,DEL,2308,4,3,1,0.17
barcode11,5,70941535,T,DEL,2283,111,111,0,4.86
barcode11,5,70941536,T,DEL,2235,2,2,0,0.09
barcode11,5,70941537,C,DEL,2186,4,4,0,0.18
barcode11,5,70941538,A,DEL,2169,5,1,4,0.23
barcode11,5,70942315,A,DEL,220,3,3,0,1.36
barcode11,5,70942320,A,DEL,346,7,0,7,2.02
barcode11,5,70942323,T,DEL,378,2,2,0,0.53
barcode11,5,70942324,G,DEL,406,2,2,0,0.49
barcode11,5,70942327,T,DEL,422,1,0,1,0.24
barcode11,5,70942328,G,DEL,425,1,0,1,0.24
barcode11,5,70942329,C,DEL,445,1,0,1,0.22
barcode11,5,70942333,T,DEL,459,25,4,21,5.45
barcode11,5,70942334,A,DEL,464,15,4,11,3.23
barcode11,5,70942335,T,DEL,469,2,0,2,0.43
barcode11,5,70942336,A,DEL,470,2,0,2,0.43
barcode11,5,70942337,T,DEL,473,2,0,2,0.42
barcode11,5,70942338,A,DEL,476,4,0,4,0.84
barcode11,5,70942339,T,DEL,477,11,0,11,2.31
barcode11,5,70942340,C,DEL,478,4,0,4,0.84
barcode11,5,70942341,T,DEL,480,39,30,9,8.12
barcode11,5,70942342,T,DEL,840,5,0,5,0.6
barcode11,5,70942343,T,DEL,843,5,0,5,0.59
barcode11,5,70942344,G,DEL,845,16,0,16,1.89
barcode11,5,70942345,A,DEL,860,3,0,3,0.35
barcode11,5,70942346,T,DEL,861,5,1,4,0.58
barcode11,5,70942349,C,DEL,880,1,1,0,0.11
barcode11,5,70942350,T,DEL,883,63,43,20,7.13
barcode11,5,70942351,T,DEL,891,2,2,0,0.22
barcode11,5,70942353,T,DEL,899,1,0,1,0.11
barcode11,5,70942354,G,DEL,1180,1,0,1,0.08
barcode11,5,70942355,T,DEL,1214,3,0,3,0.25
barcode11,5,70942357,G,DEL,1374,1,1,0,0.07
barcode11,5,70942359,G,DEL,1393,9,8,1,0.65
barcode11,5,70942360,G,DEL,1393,2,0,2,0.14
barcode11,5,70942361,A,DEL,1394,135,27,108,9.68
barcode11,5,70942362,A,DEL,1394,1,0,1,0.07
barcode11,5,70942363,A,DEL,1395,1,1,0,0.07
barcode11,5,70942364,G,DEL,1395,2,1,1,0.14
barcode11,5,70942365,T,DEL,1405,4,3,1,0.28
barcode11,5,70942366,T,DEL,1425,1,1,0,0.07
barcode11,5,70942367,G,DEL,1440,79,27,52,5.49
barcode11,5,70942368,G,DEL,1454,3,2,1,0.21
barcode11,5,70942369,G,DEL,1458,2,2,0,0.14
barcode11,5,70942370,G,DEL,1458,2,1,1,0.14
barcode11,5,70942371,A,DEL,1458,7,2,5,0.48
barcode11,5,70942372,C,DEL,1458,11,0,11,0.75
barcode11,5,70942373,A,DEL,1460,43,2,41,2.95
barcode11,5,70942374,A,DEL,1463,2,2,0,0.14
barcode11,5,70942375,A,DEL,1464,3,3,0,0.2
barcode11,5,70942376,T,DEL,1465,2,2,0,0.14
barcode11,5,70942377,G,DEL,1466,1,1,0,0.07
barcode11,5,70942378,T,DEL,1489,7,6,1,0.47
barcode11,5,70942379,T,DEL,1493,3,3,0,0.2
barcode11,5,70942380,C,DEL,1497,10,4,6,0.67
barcode11,5,70942381,T,DEL,1498,4,1,3,0.27
barcode11,5,70942382,G,DEL,1506,12,12,0,0.8
barcode11,5,70942383,C,DEL,1508,15,15,0,0.99
barcode11,5,70942384,C,DEL,1510,2,2,0,0.13
barcode11,5,70942385,A,DEL,1510,3,3,0,0.2
barcode11,5,70942386,T,DEL,1511,60,59,1,3.97
barcode11,5,70942387,T,DEL,1514,3,2,1,0.2
barcode11,5,70942388,T,DEL,1515,4,3,1,0.26
barcode11,5,70942389,G,DEL,1516,4,4,0,0.26
barcode11,5,70942390,G,DEL,1518,3,3,0,0.2
barcode11,5,70942391,T,DEL,1519,1,1,0,0.07
barcode11,5,70942392,C,DEL,1519,19,19,0,1.25
barcode11,5,70942393,A,DEL,1521,19,1,18,1.25
barcode11,5,70942394,G,DEL,1522,21,2,19,1.38
barcode11,5,70942395,A,DEL,1528,9,7,2,0.59
barcode11,5,70942396,A,DEL,1528,3,2,1,0.2
barcode11,5,70942397,G,DEL,1529,3,3,0,0.2
barcode11,5,70942398,A,DEL,1533,54,54,0,3.52
barcode11,5,70942399,C,DEL,1533,4,4,0,0.26
barcode11,5,70942400,G,DEL,1541,5,4,1,0.32
barcode11,5,70942401,G,DEL,1547,4,4,0,0.26
barcode11,5,70942402,T,DEL,1547,130,130,0,8.4
barcode11,5,70942403,T,DEL,1547,4,4,0,0.26
barcode11,5,70942404,G,DEL,1552,1,1,0,0.06
barcode11,5,70942405,C,DEL,1557,1,1,0,0.06
barcode11,5,70942406,A,DEL,1557,3,3,0,0.19
barcode11,5,70942407,T,DEL,1562,86,72,14,5.51
barcode11,5,70942408,T,DEL,1595,3,3,0,0.19
barcode11,5,70942410,A,DEL,1629,1,1,0,0.06
barcode11,5,70942411,C,DEL,1631,69,68,1,4.23
barcode11,5,70942412,C,DEL,1640,2,2,0,0.12
barcode11,5,70942414,A,DEL,1648,1,1,0,0.06
barcode11,5,70942415,G,DEL,1650,3,3,0,0.18
barcode11,5,70942418,A,DEL,1660,16,16,0,0.96
barcode11,5,70942419,C,DEL,1663,13,13,0,0.78
barcode11,5,70942420,C,DEL,1674,5,5,0,0.3
barcode11,5,70942422,T,DEL,1682,7,7,0,0.42
barcode11,5,70942423,T,DEL,1682,3,2,1,0.18
barcode11,5,70942424,G,DEL,1805,6,5,1,0.33
barcode11,5,70942425,C,DEL,1826,3,3,0,0.16
barcode11,5,70942426,T,DEL,1848,59,59,0,3.19
barcode11,5,70942429,A,DEL,1988,26,24,2,1.31
barcode11,5,70942430,A,DEL,1996,1,1,0,0.05
barcode11,5,70942431,T,DEL,1997,5,5,0,0.25
barcode11,5,70942432,T,DEL,1990,4,4,0,0.2
barcode11,5,70942433,G,DEL,1990,5,5,0,0.25
barcode11,5,70942435,T,DEL,1991,124,117,7,6.23
barcode11,5,70942436,T,DEL,1987,7,7,0,0.35
barcode11,5,70942437,T,DEL,1981,39,39,0,1.97
barcode11,5,70942438,T,DEL,1971,155,154,1,7.86
barcode11,5,70942439,A,DEL,1972,305,291,14,15.47
barcode11,5,70942440,A,DEL,1976,181,177,4,9.16
barcode11,5,70942441,G,DEL,1979,129,125,4,6.52
barcode11,5,70942442,A,DEL,1996,84,84,0,4.21
barcode11,5,70942443,G,DEL,2004,18,18,0,0.9
barcode11,5,70942444,A,DEL,2012,44,44,0,2.19
barcode11,5,70942445,G,DEL,2010,30,29,1,1.49
barcode11,5,70942446,A,DEL,2009,27,26,1,1.34
barcode11,5,70942447,A,DEL,2023,2,2,0,0.1
barcode11,5,70942448,A,DEL,2022,2,2,0,0.1
barcode11,5,70942449,C,DEL,2022,6,6,0,0.3
barcode11,5,70942450,C,DEL,2082,1,1,0,0.05
barcode11,5,70942451,T,DEL,2086,13,13,0,0.62
barcode11,5,70942452,G,DEL,2083,13,13,0,0.62
barcode11,5,70942453,T,DEL,2083,1,1,0,0.05
barcode11,5,70942454,G,DEL,2075,1,1,0,0.05
barcode11,5,70942455,T,DEL,2075,2,2,0,0.1
barcode11,5,70942456,T,DEL,2070,1,1,0,0.05
barcode11,5,70942459,G,DEL,2100,4,4,0,0.19
barcode11,5,70942460,G,DEL,2090,2,2,0,0.1
barcode11,5,70942461,T,DEL,2091,8,7,1,0.38
barcode11,5,70942463,T,DEL,2094,1,0,1,0.05
barcode11,5,70942464,A,DEL,2104,10,9,1,0.48
barcode11,5,70942465,C,DEL,2194,2,2,0,0.09
barcode11,5,70942466,A,DEL,2202,2,2,0,0.09
barcode11,5,70942467,C,DEL,2200,2,1,1,0.09
barcode11,5,70942468,T,DEL,2204,2,0,2,0.09
barcode11,5,70942469,G,DEL,2200,2,0,2,0.09
barcode11,5,70942472,T,DEL,2197,1,1,0,0.05
barcode11,5,70942475,G,DEL,2184,1,1,0,0.05
barcode11,5,70942476,G,DEL,2185,1,1,0,0.05
barcode11,5,70942477,A,DEL,2180,10,5,5,0.46
barcode11,5,70942478,A,DEL,2178,5,4,1,0.23
barcode11,5,70942479,A,DEL,2179,5,4,1,0.23
barcode11,5,70942480,T,DEL,2182,5,4,1,0.23
barcode11,5,70942481,A,DEL,2160,48,42,6,2.22
barcode11,5,70942482,G,DEL,2157,22,15,7,1.02
barcode11,5,70942483,A,DEL,2155,8,8,0,0.37
barcode11,5,70942484,G,DEL,2155,40,40,0,1.86
barcode11,5,70942485,A,DEL,2156,44,43,1,2.04
barcode11,5,70942486,G,DEL,2151,147,147,0,6.83
barcode11,5,70942487,G,DEL,2149,21,21,0,0.98
barcode11,5,70942488,A,DEL,2147,23,22,1,1.07
barcode11,5,70942489,G,DEL,2142,7,6,1,0.33
barcode11,5,70942490,C,DEL,2141,10,5,5,0.47
barcode11,5,70942491,A,DEL,2137,28,14,14,1.31
barcode11,5,70942492,A,DEL,2135,1,0,1,0.05
barcode11,5,70942494,A,DEL,2129,14,2,12,0.66
barcode11,5,70942495,T,DEL,2120,34,16,18,1.6
barcode11,5,70942496,C,DEL,2091,20,19,1,0.96
barcode11,5,70942497,T,DEL,2091,7,5,2,0.33
barcode11,5,70942498,G,DEL,2066,9,9,0,0.44
barcode11,5,70942499,T,DEL,2069,18,18,0,0.87
barcode11,5,70942500,C,DEL,2044,12,12,0,0.59
barcode11,5,70942501,C,DEL,2043,3,3,0,0.15
barcode11,5,70942502,G,DEL,2038,9,2,7,0.44
barcode11,5,70942503,A,DEL,2029,1,0,1,0.05
barcode11,5,70942504,T,DEL,2029,5,4,1,0.25
barcode11,5,70942505,C,DEL,2018,6,6,0,0.3
barcode11,5,70942506,T,DEL,2015,7,0,7,0.35
barcode11,5,70942507,A,DEL,2018,5,5,0,0.25
barcode11,5,70942508,C,DEL,2020,13,13,0,0.64
barcode11,5,70942509,T,DEL,2022,80,65,15,3.96
barcode11,5,70942510,T,DEL,2046,11,4,7,0.54
barcode11,5,70942511,T,DEL,2037,296,280,16,14.53
barcode11,5,70942512,C,DEL,2043,771,745,26,37.74
barcode11,5,70942513,C,DEL,2285,65,65,0,2.84
barcode11,5,70942514,C,DEL,2291,2,2,0,0.09
barcode11,5,70942515,C,DEL,2294,3,3,0,0.13
barcode11,5,70942516,A,DEL,2292,4,4,0,0.17
barcode11,5,70942517,A,DEL,2299,3,3,0,0.13
barcode11,5,70942518,T,DEL,2300,6,5,1,0.26
barcode11,5,70942519,C,DEL,2430,9,9,0,0.37
barcode11,5,70942520,T,DEL,2434,2,2,0,0.08
barcode11,5,70942521,G,DEL,2437,4,4,0,0.16
barcode11,5,70942522,T,DEL,2438,11,11,0,0.45
barcode11,5,70942523,G,DEL,2436,1,1,0,0.04
barcode11,5,70942524,A,DEL,2432,7,1,6,0.29
barcode11,5,70942525,A,DEL,2429,1,1,0,0.04
barcode11,5,70942526,G,DEL,2424,3,3,0,0.12
barcode11,5,70942528,A,DEL,2412,2,1,1,0.08
barcode11,5,70942529,G,DEL,2410,1,1,0,0.04
barcode11,5,70942531,T,DEL,2409,6,5,1,0.25
barcode11,5,70942532,A,DEL,2391,9,5,4,0.38
barcode11,5,70942533,A,DEL,2382,6,5,1,0.25
barcode11,5,70942534,T,DEL,2382,1,1,0,0.04
barcode11,5,70942535,A,DEL,2361,2,2,0,0.08
barcode11,5,70942536,A,DEL,2356,8,8,0,0.34
barcode11,5,70942537,T,DEL,2356,8,8,0,0.34
barcode11,5,70942538,A,DEL,2317,1,1,0,0.04
barcode11,5,70942539,T,DEL,2312,4,4,0,0.17
barcode11,5,70942540,A,DEL,2303,4,4,0,0.17
barcode11,5,70942541,G,DEL,2289,33,33,0,1.44
barcode11,5,70942542,A,DEL,2289,7,6,1,0.31
barcode11,5,70942543,A,DEL,2275,1,1,0,0.04
barcode11,5,70942544,C,DEL,2265,2,2,0,0.09
barcode11,5,70942545,A,DEL,2248,13,11,2,0.58
barcode11,5,70942546,A,DEL,2237,1,1,0,0.04
barcode11,5,70942549,T,DEL,2229,1,1,0,0.04
barcode11,5,70942550,G,DEL,2216,1,1,0,0.05
barcode11,5,70942551,C,DEL,2152,3,3,0,0.14
barcode11,5,70942552,T,DEL,2150,1,1,0,0.05
barcode11,5,70942553,C,DEL,2126,4,4,0,0.19
barcode11,5,70942554,A,DEL,2125,7,5,2,0.33
barcode11,5,70942555,A,DEL,2124,5,5,0,0.24
barcode11,5,70942556,G,DEL,2119,7,7,0,0.33
barcode11,5,70942557,A,DEL,2109,85,85,0,4.03
barcode11,5,70942558,G,DEL,2093,8,8,0,0.38
barcode11,5,70942559,G,DEL,2088,6,6,0,0.29
barcode11,5,70942560,T,DEL,2079,3,3,0,0.14
barcode11,5,70942561,A,DEL,2058,2,2,0,0.1
barcode11,5,70942562,A,DEL,2046,1,1,0,0.05
barcode11,5,70942563,G,DEL,2044,5,5,0,0.24
barcode11,5,70942564,G,DEL,2027,2,2,0,0.1
barcode11,5,70942565,A,DEL,1998,3,3,0,0.15
barcode11,5,70942567,A,DEL,1969,4,4,0,0.2
barcode11,5,70942568,C,DEL,1965,1,1,0,0.05
barcode11,5,70942569,A,DEL,1942,287,286,1,14.78
barcode11,5,70942570,A,DEL,1942,228,228,0,11.74
barcode11,5,70942571,A,DEL,1941,139,139,0,7.16
barcode11,5,70942572,A,DEL,1936,41,41,0,2.12
barcode11,5,70942573,A,DEL,1905,1,1,0,0.05
barcode11,5,70942579,A,DEL,1134,1,1,0,0.09
barcode11,5,70942580,A,DEL,875,1,1,0,0.11
barcode11,5,70942581,A,DEL,773,2,2,0,0.26
barcode11,5,70942582,T,DEL,744,2,2,0,0.27
barcode11,5,70942587,T,DEL,622,2,2,0,0.32
barcode11,5,70942678,A,DEL,926,13,1,12,1.4
barcode11,5,70942682,T,DEL,1123,3,0,3,0.27
barcode11,5,70942683,T,DEL,1128,2,0,2,0.18
barcode11,5,70942686,A,DEL,1162,4,0,4,0.34
barcode11,5,70942687,A,DEL,1163,3,0,3,0.26
barcode11,5,70942688,C,DEL,1164,3,0,3,0.26
barcode11,5,70942689,A,DEL,1164,30,1,29,2.58
barcode11,5,70942690,A,DEL,1173,1,0,1,0.09
barcode11,5,70942696,T,DEL,1206,3,0,3,0.25
barcode11,5,70942698,C,DEL,1212,1,0,1,0.08
barcode11,5,70942699,A,DEL,1213,5,0,5,0.41
barcode11,5,70942700,T,DEL,1214,13,0,13,1.07
barcode11,5,70942701,A,DEL,1220,10,0,10,0.82
barcode11,5,70942702,T,DEL,1221,50,3,47,4.1
barcode11,5,70942703,T,DEL,1225,9,0,9,0.73
barcode11,5,70942704,T,DEL,1226,7,0,7,0.57
barcode11,5,70942705,T,DEL,1231,7,0,7,0.57
barcode11,5,70942706,T,DEL,1233,22,0,22,1.78
barcode11,5,70942707,T,DEL,1233,41,0,41,3.33
barcode11,5,70942708,C,DEL,1238,60,3,57,4.85
barcode11,5,70942709,T,DEL,1246,186,4,182,14.93
barcode11,5,70942710,T,DEL,1252,24,1,23,1.92
barcode11,5,70942711,T,DEL,1258,1,0,1,0.08
barcode11,5,70942713,T,DEL,1261,13,0,13,1.03
barcode11,5,70942714,A,DEL,1271,55,0,55,4.33
barcode11,5,70942715,A,DEL,1275,1,0,1,0.08
barcode11,5,70942718,A,DEL,1283,20,1,19,1.56
barcode11,5,70942721,G,DEL,1284,8,0,8,0.62
barcode11,5,70942722,A,DEL,1288,154,15,139,11.96
barcode11,5,70942723,A,DEL,1291,15,0,15,1.16
barcode11,5,70942727,G,DEL,1292,55,0,55,4.26
barcode11,5,70942728,A,DEL,1302,4,0,4,0.31
barcode11,5,70942729,A,DEL,1302,1,0,1,0.08
barcode11,5,70942731,G,DEL,1319,1,0,1,0.08
barcode11,5,70942732,C,DEL,1324,1,0,1,0.08
barcode11,5,70942733,C,DEL,1329,1,0,1,0.08
barcode11,5,70942734,A,DEL,1329,23,0,23,1.73
barcode11,5,70942735,A,DEL,1330,1,0,1,0.08
barcode11,5,70942736,G,DEL,1324,1,0,1,0.08
barcode11,5,70942737,T,DEL,1326,18,2,16,1.36
barcode11,5,70942740,C,DEL,1341,5,1,4,0.37
barcode11,5,70942741,A,DEL,1344,10,0,10,0.74
barcode11,5,70942742,A,DEL,1348,1,0,1,0.07
barcode11,5,70942743,C,DEL,1349,2,0,2,0.15
barcode11,5,70942745,G,DEL,1349,1,0,1,0.07
barcode11,5,70942746,A,DEL,1349,5,0,5,0.37
barcode11,5,70942748,G,DEL,1349,3,0,3,0.22
barcode11,5,70942749,A,DEL,1352,103,2,101,7.62
barcode11,5,70942751,A,DEL,1345,1,0,1,0.07
barcode11,5,70942752,G,DEL,1344,2,1,1,0.15
barcode11,5,70942753,T,DEL,1341,2,1,1,0.15
barcode11,5,70942754,G,DEL,1338,7,0,7,0.52
barcode11,5,70942755,A,DEL,1338,13,0,13,0.97
barcode11,5,70942756,G,DEL,1335,13,3,10,0.97
barcode11,5,70942757,A,DEL,1339,62,0,62,4.63
barcode11,5,70942759,C,DEL,1340,2,0,2,0.15
barcode11,5,70942761,C,DEL,1377,10,0,10,0.73
barcode11,5,70942763,A,DEL,1383,1,0,1,0.07
barcode11,5,70942764,G,DEL,1384,7,6,1,0.51
barcode11,5,70942766,T,DEL,1377,52,1,51,3.78
barcode11,5,70942767,C,DEL,1375,64,1,63,4.65
barcode11,5,70942768,T,DEL,1382,13,0,13,0.94
barcode11,5,70942769,C,DEL,1389,23,0,23,1.66
barcode11,5,70942770,C,DEL,1416,5,0,5,0.35
barcode11,5,70942771,T,DEL,1417,1,0,1,0.07
barcode11,5,70942772,G,DEL,1417,19,0,19,1.34
barcode11,5,70942773,G,DEL,1413,3,0,3,0.21
barcode11,5,70942774,A,DEL,1409,43,0,43,3.05
barcode11,5,70942775,A,DEL,1393,7,0,7,0.5
barcode11,5,70942776,A,DEL,1391,5,0,5,0.36
barcode11,5,70942777,T,DEL,1390,8,0,8,0.58
barcode11,5,70942778,A,DEL,1388,9,0,9,0.65
barcode11,5,70942782,C,DEL,1396,1,0,1,0.07
barcode11,5,70942783,A,DEL,1394,2,0,2,0.14
barcode11,5,70942784,G,DEL,1393,3,0,3,0.22
barcode11,5,70942785,A,DEL,1108,6,0,6,0.54
barcode11,5,70942786,T,DEL,1109,8,1,7,0.72
barcode11,5,70942787,A,DEL,1040,9,0,9,0.87
barcode11,5,70942788,A,DEL,1041,1,0,1,0.1
barcode11,5,70942789,C,DEL,1043,1,0,1,0.1
barcode11,5,70942793,A,DEL,1036,4,0,4,0.39
barcode11,5,70942795,G,DEL,1020,1,0,1,0.1
barcode11,5,70942796,C,DEL,1025,23,11,12,2.24
barcode11,5,70942798,C,DEL,987,2,0,2,0.2
barcode11,5,70942799,A,DEL,933,9,4,5,0.96
barcode11,5,70942800,A,DEL,938,1,0,1,0.11
barcode11,5,70942801,A,DEL,935,7,0,7,0.75
barcode11,5,70942802,T,DEL,931,44,0,44,4.73
barcode11,5,70942803,C,DEL,941,24,0,24,2.55
barcode11,5,70942804,T,DEL,953,10,3,7,1.05
barcode11,5,70942805,G,DEL,1017,3,3,0,0.29
barcode11,5,70942806,C,DEL,1016,3,1,2,0.3
barcode11,5,70942807,T,DEL,1046,2,1,1,0.19
barcode11,5,70942808,C,DEL,1047,7,1,6,0.67
barcode11,5,70942812,G,DEL,1040,7,2,5,0.67
barcode11,5,70942814,A,DEL,1034,1,0,1,0.1
barcode11,5,70942816,C,DEL,1003,2,1,1,0.2
barcode11,5,70942817,T,DEL,1002,2,1,1,0.2
barcode11,5,70942818,C,DEL,998,6,3,3,0.6
barcode11,5,70942819,T,DEL,1000,82,7,75,8.2
barcode11,5,70942820,T,DEL,1006,22,1,21,2.19
barcode11,5,70942821,T,DEL,995,34,3,31,3.42
barcode11,5,70942822,T,DEL,987,64,3,61,6.48
barcode11,5,70942823,C,DEL,988,84,4,80,8.5
barcode11,5,70942824,T,DEL,986,86,0,86,8.72
barcode11,5,70942825,C,DEL,990,185,20,165,18.69
barcode11,5,70942826,C,DEL,993,74,1,73,7.45
barcode11,5,70942827,C,DEL,985,44,0,44,4.47
barcode11,5,70942828,T,DEL,984,52,0,52,5.28
barcode11,5,70942829,C,DEL,985,71,4,67,7.21
barcode11,5,70942830,C,DEL,996,24,4,20,2.41
barcode11,5,70942831,A,DEL,1001,11,5,6,1.1
barcode11,5,70942832,C,DEL,1005,4,2,2,0.4
barcode11,5,70942833,C,DEL,1005,5,2,3,0.5
barcode11,5,70942834,A,DEL,1005,8,3,5,0.8
barcode11,5,70942835,C,DEL,1005,232,168,64,23.08
barcode11,5,70942836,C,DEL,956,6,6,0,0.63
barcode11,5,70942837,C,DEL,955,5,5,0,0.52
barcode11,5,70942838,C,DEL,955,2,2,0,0.21
barcode11,5,70942839,C,DEL,944,1,0,1,0.11
barcode11,5,70942840,C,DEL,940,1,0,1,0.11
barcode11,5,70942841,A,DEL,939,2,0,2,0.21
barcode11,5,70942842,T,DEL,939,2,0,2,0.21
barcode11,5,70942843,G,DEL,938,1,0,1,0.11
barcode11,5,70942844,C,DEL,941,9,7,2,0.96
barcode11,5,70942846,A,DEL,942,3,1,2,0.32
barcode11,5,70942847,G,DEL,944,20,15,5,2.12
barcode11,5,70942848,G,DEL,939,1,0,1,0.11
barcode11,5,70942849,G,DEL,939,1,0,1,0.11
barcode11,5,70942850,C,DEL,936,1,0,1,0.11
barcode11,5,70942851,C,DEL,934,1,0,1,0.11
barcode11,5,70942852,A,DEL,934,55,14,41,5.89
barcode11,5,70942853,A,DEL,932,1,0,1,0.11
barcode11,5,70942854,G,DEL,928,1,0,1,0.11
barcode11,5,70942855,A,DEL,928,1,1,0,0.11
barcode11,5,70942857,T,DEL,927,29,0,29,3.13
barcode11,5,70942858,G,DEL,927,35,1,34,3.78
barcode11,5,70942859,G,DEL,928,1,0,1,0.11
barcode11,5,70942861,A,DEL,928,1,0,1,0.11
barcode11,5,70942862,C,DEL,929,3,2,1,0.32
barcode11,5,70942863,C,DEL,929,1,0,1,0.11
barcode11,5,70942864,A,DEL,926,1,0,1,0.11
barcode11,5,70942865,G,DEL,926,2,0,2,0.22
barcode11,5,70942866,G,DEL,914,4,2,2,0.44
barcode11,5,70942867,A,DEL,910,65,12,53,7.14
barcode11,5,70942868,A,DEL,905,1,0,1,0.11
barcode11,5,70942869,A,DEL,901,1,0,1,0.11
barcode11,5,70942870,G,DEL,901,1,0,1,0.11
barcode11,5,70942871,G,DEL,901,2,0,2,0.22
barcode11,5,70942872,T,DEL,901,16,0,16,1.78
barcode11,5,70942873,A,DEL,897,13,0,13,1.45
barcode11,5,70942874,A,DEL,894,8,0,8,0.89
barcode11,5,70942875,A,DEL,893,5,0,5,0.56
barcode11,5,70942876,C,DEL,890,7,0,7,0.79
barcode11,5,70942877,C,DEL,888,3,0,3,0.34
barcode11,5,70942878,T,DEL,888,6,2,4,0.68
barcode11,5,70942879,T,DEL,885,2,1,1,0.23
barcode11,5,70942880,C,DEL,888,1,1,0,0.11
barcode11,5,70942881,T,DEL,880,13,0,13,1.48
barcode11,5,70942884,G,DEL,834,2,1,1,0.24
barcode11,5,70942885,A,DEL,818,41,4,37,5.01
barcode11,5,70942886,A,DEL,817,5,0,5,0.61
barcode11,5,70942887,A,DEL,801,1,0,1,0.12
barcode11,5,70942888,G,DEL,801,1,0,1,0.12
barcode11,5,70942889,T,DEL,800,21,9,12,2.62
barcode11,5,70942890,T,DEL,797,1,1,0,0.13
barcode11,5,70942893,C,DEL,793,5,3,2,0.63
barcode11,5,70942894,C,DEL,793,4,0,4,0.5
barcode11,5,70942895,A,DEL,790,32,19,13,4.05
barcode11,5,70942896,G,DEL,790,38,23,15,4.81
barcode11,5,70942897,A,DEL,765,39,2,37,5.1
barcode11,5,70942898,A,DEL,762,2,2,0,0.26
barcode11,5,70942901,T,DEL,760,1,0,1,0.13
barcode11,5,70942902,A,DEL,756,1,1,0,0.13
barcode11,5,70942904,T,DEL,754,13,11,2,1.72
barcode11,5,70942905,T,DEL,749,1,0,1,0.13
barcode11,5,70942906,A,DEL,746,81,0,81,10.86
barcode11,5,70942908,T,DEL,735,1,1,0,0.14
barcode11,5,70942909,G,DEL,734,1,1,0,0.14
barcode11,5,70942911,C,DEL,729,23,20,3,3.16
barcode11,5,70942912,G,DEL,729,20,4,16,2.74
barcode11,5,70942914,G,DEL,705,1,0,1,0.14
barcode11,5,70942915,A,DEL,687,2,0,2,0.29
barcode11,5,70942918,T,DEL,683,32,15,17,4.69
barcode11,5,70942920,T,DEL,663,8,0,8,1.21
barcode11,5,70942921,A,DEL,659,10,0,10,1.52
barcode11,5,70942923,C,DEL,654,1,0,1,0.15
barcode11,5,70942924,C,DEL,654,1,1,0,0.15
barcode11,5,70942925,T,DEL,653,1,1,0,0.15
barcode11,5,70942927,T,DEL,637,1,0,1,0.16
barcode11,5,70942928,C,DEL,629,2,0,2,0.32
barcode11,5,70942929,T,DEL,622,10,0,10,1.61
barcode11,5,70942930,G,DEL,617,1,1,0,0.16
barcode11,5,70942931,T,DEL,611,6,6,0,0.98
barcode11,5,70942939,T,DEL,514,13,13,0,2.53
barcode11,5,70942947,T,DEL,291,2,0,2,0.69
barcode11,5,70942948,C,DEL,270,4,0,4,1.48
barcode11,5,70942949,T,DEL,261,2,0,2,0.77
barcode11,5,70942950,C,DEL,183,2,0,2,1.09
barcode11,5,70943031,A,DEL,1,1,0,1,100.0
barcode11,5,70943032,A,DEL,1,1,0,1,100.0
barcode11,5,70944618,A,DEL,1157,2,0,2,0.17
barcode11,5,70944621,T,DEL,1264,2,0,2,0.16
barcode11,5,70944623,G,DEL,1321,1,0,1,0.08
barcode11,5,70944624,G,DEL,1346,1,0,1,0.07
barcode11,5,70944625,T,DEL,1353,11,0,11,0.81
barcode11,5,70944626,A,DEL,1387,61,0,61,4.4
barcode11,5,70944628,G,DEL,1407,5,0,5,0.36
barcode11,5,70944633,T,DEL,1446,48,2,46,3.32
barcode11,5,70944639,T,DEL,1502,31,18,13,2.06
barcode11,5,70944640,T,DEL,1515,2,0,2,0.13
barcode11,5,70944641,T,DEL,1519,2,0,2,0.13
barcode11,5,70944642,G,DEL,1524,24,0,24,1.57
barcode11,5,70944643,A,DEL,1542,13,1,12,0.84
barcode11,5,70944644,A,DEL,1550,2,0,2,0.13
barcode11,5,70944647,A,DEL,1578,4,0,4,0.25
barcode11,5,70944648,T,DEL,1580,15,7,8,0.95
barcode11,5,70944649,T,DEL,1598,34,0,34,2.13
barcode11,5,70944650,C,DEL,1609,38,0,38,2.36
barcode11,5,70944651,C,DEL,1615,2,0,2,0.12
barcode11,5,70944652,T,DEL,1617,24,1,23,1.48
barcode11,5,70944653,T,DEL,1623,19,0,19,1.17
barcode11,5,70944661,G,DEL,1768,7,6,1,0.4
barcode11,5,70944662,G,DEL,1775,1,1,0,0.06
barcode11,5,70944663,T,DEL,1779,6,0,6,0.34
barcode11,5,70944664,C,DEL,1780,4,0,4,0.22
barcode11,5,70944665,T,DEL,1788,21,0,21,1.17
barcode11,5,70944666,A,DEL,1800,32,5,27,1.78
barcode11,5,70944667,A,DEL,1805,10,0,10,0.55
barcode11,5,70944668,A,DEL,1806,13,0,13,0.72
barcode11,5,70944669,A,DEL,1807,14,1,13,0.77
barcode11,5,70944670,T,DEL,1821,26,2,24,1.43
barcode11,5,70944671,T,DEL,1829,1,0,1,0.05
barcode11,5,70944672,C,DEL,1837,2,0,2,0.11
barcode11,5,70944673,A,DEL,1841,8,0,8,0.43
barcode11,5,70944676,G,DEL,1858,1,1,0,0.05
barcode11,5,70944678,C,DEL,1884,50,1,49,2.65
barcode11,5,70944679,C,DEL,1903,8,3,5,0.42
barcode11,5,70944680,C,DEL,1914,7,3,4,0.37
barcode11,5,70944681,A,DEL,1925,18,13,5,0.94
barcode11,5,70944682,C,DEL,1937,3,0,3,0.15
barcode11,5,70944683,C,DEL,1945,3,0,3,0.15
barcode11,5,70944684,A,DEL,1964,4,0,4,0.2
barcode11,5,70944685,C,DEL,1967,4,0,4,0.2
barcode11,5,70944686,C,DEL,1968,4,0,4,0.2
barcode11,5,70944687,G,DEL,1993,6,0,6,0.3
barcode11,5,70944688,C,DEL,2001,1,0,1,0.05
barcode11,5,70944689,C,DEL,2002,1,1,0,0.05
barcode11,5,70944690,A,DEL,2015,2,1,1,0.1
barcode11,5,70944691,C,DEL,2019,8,7,1,0.4
barcode11,5,70944692,C,DEL,2014,7,6,1,0.35
barcode11,5,70944693,G,DEL,2038,10,7,3,0.49
barcode11,5,70944694,C,DEL,2045,20,6,14,0.98
barcode11,5,70944695,C,DEL,2041,19,5,14,0.93
barcode11,5,70944696,A,DEL,2058,20,6,14,0.97
barcode11,5,70944697,C,DEL,2060,8,8,0,0.39
barcode11,5,70944698,C,DEL,2056,1,1,0,0.05
barcode11,5,70944699,A,DEL,2092,2,2,0,0.1
barcode11,5,70944700,C,DEL,2095,1,0,1,0.05
barcode11,5,70944701,C,DEL,2094,2,0,2,0.1
barcode11,5,70944702,A,DEL,2150,3,1,2,0.14
barcode11,5,70944703,C,DEL,2149,8,3,5,0.37
barcode11,5,70944704,C,DEL,2136,8,2,6,0.37
barcode11,5,70944705,A,DEL,2148,9,3,6,0.42
barcode11,5,70944706,C,DEL,2152,207,184,23,9.62
barcode11,5,70944707,C,DEL,2169,22,0,22,1.01
barcode11,5,70944709,C,DEL,2209,1,0,1,0.05
barcode11,5,70944710,A,DEL,2195,2,0,2,0.09
barcode11,5,70944711,C,DEL,2185,1,0,1,0.05
barcode11,5,70944712,T,DEL,2180,15,12,3,0.69
barcode11,5,70944713,T,DEL,2165,4,2,2,0.18
barcode11,5,70944714,A,DEL,2188,40,39,1,1.83
barcode11,5,70944715,C,DEL,2183,3,2,1,0.14
barcode11,5,70944716,T,DEL,2173,1,0,1,0.05
barcode11,5,70944718,T,DEL,2159,1,1,0,0.05
barcode11,5,70944722,G,DEL,2105,1,0,1,0.05
barcode11,5,70944723,C,DEL,2131,22,6,16,1.03
barcode11,5,70944724,T,DEL,2132,35,0,35,1.64
barcode11,5,70944725,G,DEL,2127,4,0,4,0.19
barcode11,5,70944726,G,DEL,2131,2,0,2,0.09
barcode11,5,70944727,C,DEL,2122,3,0,3,0.14
barcode11,5,70944728,T,DEL,2123,5,0,5,0.24
barcode11,5,70944729,G,DEL,2121,11,5,6,0.52
barcode11,5,70944730,C,DEL,2117,24,0,24,1.13
barcode11,5,70944731,C,DEL,2120,3,0,3,0.14
barcode11,5,70944733,C,DEL,2128,6,1,5,0.28
barcode11,5,70944734,C,DEL,2135,1,1,0,0.05
barcode11,5,70944736,T,DEL,2135,24,8,16,1.12
barcode11,5,70944737,T,DEL,2124,1,0,1,0.05
barcode11,5,70944738,T,DEL,2124,1,0,1,0.05
barcode11,5,70944739,C,DEL,2132,3,1,2,0.14
barcode11,5,70944740,C,DEL,2139,5,2,3,0.23
barcode11,5,70944741,T,DEL,2143,47,13,34,2.19
barcode11,5,70944742,T,DEL,2155,12,4,8,0.56
barcode11,5,70944743,C,DEL,2162,14,3,11,0.65
barcode11,5,70944744,T,DEL,2157,12,0,12,0.56
barcode11,5,70944745,G,DEL,2149,1,1,0,0.05
barcode11,5,70944748,C,DEL,2112,2,2,0,0.09
barcode11,5,70944749,C,DEL,2116,1,1,0,0.05
barcode11,5,70944750,A,DEL,2169,1,1,0,0.05
barcode11,5,70944751,C,DEL,2167,6,6,0,0.28
barcode11,5,70944753,A,DEL,2162,11,4,7,0.51
barcode11,5,70944754,G,DEL,2156,7,0,7,0.32
barcode11,5,70944755,T,DEL,2146,18,1,17,0.84
barcode11,5,70944756,A,DEL,2101,18,1,17,0.86
barcode11,5,70944757,A,DEL,2097,14,0,14,0.67
barcode11,5,70944758,G,DEL,2091,14,0,14,0.67
barcode11,5,70944759,T,DEL,2096,57,0,57,2.72
barcode11,5,70944760,A,DEL,2071,463,27,436,22.36
barcode11,5,70944761,A,DEL,2071,222,4,218,10.72
barcode11,5,70944762,A,DEL,2070,201,2,199,9.71
barcode11,5,70944763,A,DEL,2069,61,2,59,2.95
barcode11,5,70944764,A,DEL,2068,4,2,2,0.19
barcode11,5,70944765,A,DEL,2057,8,4,4,0.39
barcode11,5,70944766,G,DEL,2053,8,4,4,0.39
barcode11,5,70944767,A,DEL,2055,5,3,2,0.24
barcode11,5,70944768,G,DEL,2047,1,0,1,0.05
barcode11,5,70944769,T,DEL,2044,97,0,97,4.75
barcode11,5,70944770,A,DEL,2032,3,0,3,0.15
barcode11,5,70944771,T,DEL,2031,7,0,7,0.34
barcode11,5,70944772,A,DEL,2032,1,1,0,0.05
barcode11,5,70944773,G,DEL,2031,1,0,1,0.05
barcode11,5,70944775,T,DEL,2027,2,2,0,0.1
barcode11,5,70944777,A,DEL,1986,9,3,6,0.45
barcode11,5,70944778,G,DEL,1981,28,17,11,1.41
barcode11,5,70944779,A,DEL,1964,5,0,5,0.25
barcode11,5,70944780,T,DEL,1965,62,13,49,3.16
barcode11,5,70944781,T,DEL,1949,2,0,2,0.1
barcode11,5,70944782,T,DEL,1940,2,0,2,0.1
barcode11,5,70944783,T,DEL,1937,2,0,2,0.1
barcode11,5,70944784,G,DEL,1927,2,1,1,0.1
barcode11,5,70944785,C,DEL,1918,1,0,1,0.05
barcode11,5,70944786,T,DEL,1916,18,5,13,0.94
barcode11,5,70944789,C,DEL,1882,2,2,0,0.11
barcode11,5,70944790,A,DEL,1872,3,1,2,0.16
barcode11,5,70944793,T,DEL,1812,1,0,1,0.06
barcode11,5,70944795,C,DEL,1768,3,1,2,0.17
barcode11,5,70944798,T,DEL,1735,18,9,9,1.04
barcode11,5,70944800,T,DEL,1701,5,0,5,0.29
barcode11,5,70944801,G,DEL,1689,6,0,6,0.36
barcode11,5,70944802,A,DEL,1647,10,1,9,0.61
barcode11,5,70944803,T,DEL,1638,4,1,3,0.24
barcode11,5,70944804,A,DEL,1602,1,1,0,0.06
barcode11,5,70944806,T,DEL,1591,3,3,0,0.19
barcode11,5,70944808,A,DEL,1566,1,1,0,0.06
barcode11,5,70944809,G,DEL,1563,3,1,2,0.19
barcode11,5,70944812,G,DEL,1501,1,1,0,0.07
barcode11,5,70944813,A,DEL,1477,14,13,1,0.95
barcode11,5,70944814,A,DEL,1438,1,0,1,0.07
barcode11,5,70944815,T,DEL,1403,1,0,1,0.07
barcode11,5,70944816,A,DEL,1354,19,17,2,1.4
barcode11,5,70944817,G,DEL,1321,11,8,3,0.83
barcode11,5,70944818,A,DEL,1315,1,0,1,0.08
barcode11,5,70944819,G,DEL,1270,18,18,0,1.42
barcode11,5,70944820,G,DEL,1228,1,1,0,0.08
barcode11,5,70944821,A,DEL,1207,2,2,0,0.17
barcode11,5,70944822,T,DEL,1205,3,3,0,0.25
barcode11,5,70944825,T,DEL,1160,5,1,4,0.43
barcode11,5,70944826,A,DEL,1121,56,45,11,5.0
barcode11,5,70945984,C,DEL,2063,27,0,27,1.31
barcode11,5,70945985,C,DEL,2093,1,0,1,0.05
barcode11,5,70945986,A,DEL,2229,1,0,1,0.04
barcode11,5,70945987,G,DEL,2244,15,0,15,0.67
barcode11,5,70945989,A,DEL,2304,1,0,1,0.04
barcode11,5,70945990,T,DEL,2353,13,13,0,0.55
barcode11,5,70945994,C,DEL,2480,6,6,0,0.24
barcode11,5,70945995,T,DEL,2488,15,10,5,0.6
barcode11,5,70945996,A,DEL,2507,14,10,4,0.56
barcode11,5,70945998,A,DEL,2559,1,0,1,0.04
barcode11,5,70945999,T,DEL,2560,3,0,3,0.12
barcode11,5,70946000,A,DEL,2577,24,0,24,0.93
barcode11,5,70946001,A,DEL,2586,9,3,6,0.35
barcode11,5,70946002,T,DEL,2590,17,3,14,0.66
barcode11,5,70946003,A,DEL,2628,8,1,7,0.3
barcode11,5,70946004,T,DEL,2646,8,0,8,0.3
barcode11,5,70946005,A,DEL,2649,49,0,49,1.85
barcode11,5,70946006,A,DEL,2659,10,0,10,0.38
barcode11,5,70946007,A,DEL,2673,1,0,1,0.04
barcode11,5,70946008,T,DEL,2676,2,0,2,0.07
barcode11,5,70946009,C,DEL,2769,5,0,5,0.18
barcode11,5,70946010,T,DEL,3300,1,0,1,0.03
barcode11,5,70946011,C,DEL,3311,17,4,13,0.51
barcode11,5,70946012,C,DEL,3334,28,0,28,0.84
barcode11,5,70946013,A,DEL,3523,67,0,67,1.9
barcode11,5,70946014,G,DEL,3533,77,9,68,2.18
barcode11,5,70946015,A,DEL,3568,4,1,3,0.11
barcode11,5,70946016,C,DEL,3573,4,1,3,0.11
barcode11,5,70946017,T,DEL,3645,64,63,1,1.76
barcode11,5,70946018,T,DEL,3662,6,5,1,0.16
barcode11,5,70946019,T,DEL,3670,10,9,1,0.27
barcode11,5,70946020,A,DEL,3773,25,24,1,0.66
barcode11,5,70946021,C,DEL,3792,10,8,2,0.26
barcode11,5,70946022,T,DEL,3800,314,127,187,8.26
barcode11,5,70946023,T,DEL,3826,13,8,5,0.34
barcode11,5,70946024,T,DEL,3843,12,10,2,0.31
barcode11,5,70946025,T,DEL,3906,5,4,1,0.13
barcode11,5,70946026,T,DEL,3929,9,8,1,0.23
barcode11,5,70946027,T,DEL,3945,12,11,1,0.3
barcode11,5,70946028,G,DEL,4073,21,20,1,0.52
barcode11,5,70946029,T,DEL,4158,36,23,13,0.87
barcode11,5,70946031,T,DEL,4217,1,1,0,0.02
barcode11,5,70946032,A,DEL,4385,52,52,0,1.19
barcode11,5,70946033,C,DEL,4406,72,5,67,1.63
barcode11,5,70946034,T,DEL,4440,1,0,1,0.02
barcode11,5,70946035,G,DEL,4464,5,0,5,0.11
barcode11,5,70946036,G,DEL,4464,2,0,2,0.04
barcode11,5,70946037,A,DEL,4480,38,3,35,0.85
barcode11,5,70946038,T,DEL,4482,38,3,35,0.85
barcode11,5,70946040,T,DEL,4498,2,0,2,0.04
barcode11,5,70946041,A,DEL,4536,209,2,207,4.61
barcode11,5,70946042,A,DEL,4543,3,3,0,0.07
barcode11,5,70946043,A,DEL,4544,3,3,0,0.07
barcode11,5,70946044,C,DEL,4552,3,1,2,0.07
barcode11,5,70946045,A,DEL,4552,26,0,26,0.57
barcode11,5,70946046,A,DEL,4552,40,38,2,0.88
barcode11,5,70946047,T,DEL,4553,45,43,2,0.99
barcode11,5,70946048,A,DEL,4607,7,1,6,0.15
barcode11,5,70946049,T,DEL,4607,11,7,4,0.24
barcode11,5,70946050,C,DEL,4611,35,7,28,0.76
barcode11,5,70946051,T,DEL,4614,854,705,149,18.51
barcode11,5,70946052,T,DEL,4622,218,194,24,4.72
barcode11,5,70946053,T,DEL,4628,95,90,5,2.05
barcode11,5,70946054,T,DEL,4652,63,61,2,1.35
barcode11,5,70946055,T,DEL,4655,86,78,8,1.85
barcode11,5,70946056,C,DEL,4667,95,84,11,2.04
barcode11,5,70946057,T,DEL,4668,46,13,33,0.99
barcode11,5,70946058,G,DEL,4681,16,14,2,0.34
barcode11,5,70946059,T,DEL,4694,7,5,2,0.15
barcode11,5,70946060,C,DEL,4707,95,6,89,2.02
barcode11,5,70946061,T,DEL,4745,10,9,1,0.21
barcode11,5,70946062,C,DEL,4752,45,43,2,0.95
barcode11,5,70946063,C,DEL,4778,6,2,4,0.13
barcode11,5,70946064,A,DEL,4782,21,13,8,0.44
barcode11,5,70946065,G,DEL,4782,52,19,33,1.09
barcode11,5,70946066,A,DEL,4769,189,1,188,3.96
barcode11,5,70946067,T,DEL,4771,204,5,199,4.28
barcode11,5,70946068,A,DEL,4785,13,6,7,0.27
barcode11,5,70946069,A,DEL,4790,10,5,5,0.21
barcode11,5,70946070,T,DEL,4818,25,7,18,0.52
barcode11,5,70946071,T,DEL,4823,15,5,10,0.31
barcode11,5,70946072,C,DEL,4840,890,342,548,18.39
barcode11,5,70946073,C,DEL,4860,152,92,60,3.13
barcode11,5,70946074,C,DEL,4890,24,18,6,0.49
barcode11,5,70946075,C,DEL,4892,19,9,10,0.39
barcode11,5,70946076,C,DEL,4880,20,10,10,0.41
barcode11,5,70946077,A,DEL,4883,22,12,10,0.45
barcode11,5,70946078,C,DEL,4885,12,7,5,0.25
barcode11,5,70946079,C,DEL,4882,1,1,0,0.02
barcode11,5,70946080,A,DEL,4889,2,1,1,0.04
barcode11,5,70946081,C,DEL,4887,14,7,7,0.29
barcode11,5,70946082,C,DEL,4884,8,6,2,0.16
barcode11,5,70946083,T,DEL,4895,13,10,3,0.27
barcode11,5,70946084,C,DEL,4896,944,940,4,19.28
barcode11,5,70946086,C,DEL,4896,3,3,0,0.06
barcode11,5,70946087,A,DEL,4882,82,10,72,1.68
barcode11,5,70946088,T,DEL,4877,83,9,74,1.7
barcode11,5,70946090,T,DEL,4820,24,24,0,0.5
barcode11,5,70946091,G,DEL,4819,27,24,3,0.56
barcode11,5,70946092,T,DEL,4837,3,3,0,0.06
barcode11,5,70946093,C,DEL,4824,31,30,1,0.64
barcode11,5,70946094,C,DEL,4835,1,1,0,0.02
barcode11,5,70946095,A,DEL,4829,11,10,1,0.23
barcode11,5,70946096,G,DEL,4820,36,14,22,0.75
barcode11,5,70946097,A,DEL,4823,14,7,7,0.29
barcode11,5,70946098,T,DEL,4846,30,2,28,0.62
barcode11,5,70946099,T,DEL,4837,665,33,632,13.75
barcode11,5,70946100,C,DEL,4838,690,50,640,14.26
barcode11,5,70946101,T,DEL,4846,8,0,8,0.17
barcode11,5,70946102,C,DEL,4822,23,14,9,0.48
barcode11,5,70946103,T,DEL,4857,122,66,56,2.51
barcode11,5,70946104,T,DEL,4863,83,4,79,1.71
barcode11,5,70946105,G,DEL,4863,123,8,115,2.53
barcode11,5,70946106,A,DEL,4886,6,6,0,0.12
barcode11,5,70946107,T,DEL,4888,1,1,0,0.02
barcode11,5,70946108,G,DEL,4881,1,1,0,0.02
barcode11,5,70946109,A,DEL,4890,1,1,0,0.02
barcode11,5,70946110,T,DEL,4871,8,8,0,0.16
barcode11,5,70946111,G,DEL,4899,8,8,0,0.16
barcode11,5,70946112,C,DEL,4925,13,12,1,0.26
barcode11,5,70946113,T,DEL,4938,5,3,2,0.1
barcode11,5,70946114,G,DEL,4932,10,3,7,0.2
barcode11,5,70946115,A,DEL,4942,5,4,1,0.1
barcode11,5,70946116,T,DEL,4933,3,1,2,0.06
barcode11,5,70946117,G,DEL,4920,1,1,0,0.02
barcode11,5,70946118,C,DEL,4890,35,6,29,0.72
barcode11,5,70946119,T,DEL,4907,36,25,11,0.73
barcode11,5,70946120,T,DEL,4935,12,11,1,0.24
barcode11,5,70946121,T,DEL,4952,3,1,2,0.06
barcode11,5,70946122,G,DEL,4952,309,21,288,6.24
barcode11,5,70946124,G,DEL,4969,16,0,16,0.32
barcode11,5,70946125,A,DEL,4960,73,10,63,1.47
barcode11,5,70946126,A,DEL,4955,2,1,1,0.04
barcode11,5,70946127,G,DEL,4940,56,25,31,1.13
barcode11,5,70946128,T,DEL,4909,112,14,98,2.28
barcode11,5,70946129,A,DEL,4953,12,10,2,0.24
barcode11,5,70946130,T,DEL,4955,6,5,1,0.12
barcode11,5,70946131,G,DEL,4967,9,9,0,0.18
barcode11,5,70946132,T,DEL,4973,610,610,0,12.27
barcode11,5,70946133,T,DEL,4970,1,1,0,0.02
barcode11,5,70946134,A,DEL,4966,16,3,13,0.32
barcode11,5,70946135,A,DEL,4981,7,3,4,0.14
barcode11,5,70946136,T,DEL,5013,74,21,53,1.48
barcode11,5,70946138,T,DEL,5100,7,7,0,0.14
barcode11,5,70946139,C,DEL,5128,12,9,3,0.23
barcode11,5,70946140,A,DEL,5155,9,9,0,0.17
barcode11,5,70946141,T,DEL,5161,4,2,2,0.08
barcode11,5,70946142,G,DEL,5073,7,4,3,0.14
barcode11,5,70946143,G,DEL,5092,9,1,8,0.18
barcode11,5,70946144,T,DEL,5088,34,3,31,0.67
barcode11,5,70946145,A,DEL,5017,7,2,5,0.14
barcode11,5,70946146,C,DEL,5048,3,1,2,0.06
barcode11,5,70946147,A,DEL,5056,2,0,2,0.04
barcode11,5,70946148,T,DEL,5059,2,0,2,0.04
barcode11,5,70946149,G,DEL,5059,2,1,1,0.04
barcode11,5,70946150,A,DEL,5121,7,7,0,0.14
barcode11,5,70946151,G,DEL,5109,11,9,2,0.22
barcode11,5,70946152,T,DEL,5116,1,1,0,0.02
barcode11,5,70946153,G,DEL,5117,1,0,1,0.02
barcode11,5,70946154,G,DEL,5132,2,1,1,0.04
barcode11,5,70946155,C,DEL,5119,4,1,3,0.08
barcode11,5,70946156,T,DEL,5108,5,2,3,0.1
barcode11,5,70946157,A,DEL,5081,5,5,0,0.1
barcode11,5,70946158,T,DEL,5090,1,1,0,0.02
barcode11,5,70946160,A,DEL,5010,7,2,5,0.14
barcode11,5,70946161,T,DEL,5010,12,6,6,0.24
barcode11,5,70946162,A,DEL,5299,5,3,2,0.09
barcode11,5,70946163,C,DEL,5303,15,3,12,0.28
barcode11,5,70946164,T,DEL,5315,16,1,15,0.3
barcode11,5,70946165,G,DEL,5328,5,4,1,0.09
barcode11,5,70946167,C,DEL,5287,1,1,0,0.02
barcode11,5,70946168,T,DEL,5277,21,21,0,0.4
barcode11,5,70946169,A,DEL,5187,28,28,0,0.54
barcode11,5,70946170,T,DEL,5174,53,53,0,1.02
barcode11,5,70946171,T,DEL,5169,116,116,0,2.24
barcode11,5,70946172,A,DEL,5195,116,116,0,2.23
barcode11,5,70946173,T,DEL,5186,31,29,2,0.6
barcode11,5,70946174,A,DEL,5267,30,29,1,0.57
barcode11,5,70946175,T,DEL,5266,3,2,1,0.06
barcode11,5,70946176,G,DEL,5263,5,4,1,0.1
barcode11,5,70946177,G,DEL,5317,57,2,55,1.07
barcode11,5,70946178,T,DEL,5319,68,2,66,1.28
barcode11,5,70946179,A,DEL,5238,33,2,31,0.63
barcode11,5,70946180,A,DEL,5230,38,0,38,0.73
barcode11,5,70946181,G,DEL,5204,34,0,34,0.65
barcode11,5,70946182,T,DEL,5206,49,4,45,0.94
barcode11,5,70946183,A,DEL,5126,98,4,94,1.91
barcode11,5,70946184,A,DEL,5125,5,4,1,0.1
barcode11,5,70946185,T,DEL,5187,3,3,0,0.06
barcode11,5,70946186,C,DEL,5166,5,4,1,0.1
barcode11,5,70946187,A,DEL,5173,4,4,0,0.08
barcode11,5,70946188,C,DEL,5187,3,2,1,0.06
barcode11,5,70946189,T,DEL,5235,5,0,5,0.1
barcode11,5,70946190,C,DEL,5239,172,7,165,3.28
barcode11,5,70946192,G,DEL,5266,25,18,7,0.47
barcode11,5,70946193,C,DEL,5260,1,1,0,0.02
barcode11,5,70946194,A,DEL,5259,3,1,2,0.06
barcode11,5,70946195,T,DEL,5260,11,10,1,0.21
barcode11,5,70946196,C,DEL,5255,23,11,12,0.44
barcode11,5,70946197,T,DEL,5267,1302,1172,130,24.72
barcode11,5,70946198,T,DEL,5280,97,97,0,1.84
barcode11,5,70946199,T,DEL,5279,9,9,0,0.17
barcode11,5,70946200,T,DEL,5260,8,2,6,0.15
barcode11,5,70946201,C,DEL,5250,14,5,9,0.27
barcode11,5,70946202,C,DEL,5264,4,3,1,0.08
barcode11,5,70946203,T,DEL,5264,5,3,2,0.09
barcode11,5,70946204,G,DEL,5262,71,2,69,1.35
barcode11,5,70946205,A,DEL,5251,4,2,2,0.08
barcode11,5,70946206,C,DEL,5243,5,3,2,0.1
barcode11,5,70946207,A,DEL,5220,1,1,0,0.02
barcode11,5,70946208,A,DEL,5221,3,0,3,0.06
barcode11,5,70946209,T,DEL,5225,267,232,35,5.11
barcode11,5,70946210,T,DEL,5230,16,8,8,0.31
barcode11,5,70946211,T,DEL,5230,6,1,5,0.11
barcode11,5,70946212,T,DEL,5230,4,0,4,0.08
barcode11,5,70946214,T,DEL,5264,3,3,0,0.06
barcode11,5,70946215,T,DEL,5260,13,8,5,0.25
barcode11,5,70946216,G,DEL,5290,13,8,5,0.25
barcode11,5,70946217,T,DEL,5294,2,0,2,0.04
barcode11,5,70946219,G,DEL,5299,1,1,0,0.02
barcode11,5,70946220,T,DEL,5305,4,4,0,0.08
barcode11,5,70946221,T,DEL,5300,3,3,0,0.06
barcode11,5,70946222,A,DEL,5300,3,3,0,0.06
barcode11,5,70946223,T,DEL,5298,5,5,0,0.09
barcode11,5,70946224,G,DEL,5326,6,6,0,0.11
barcode11,5,70946225,T,DEL,5315,10,10,0,0.19
barcode11,5,70946228,C,DEL,5305,7,4,3,0.13
barcode11,5,70946229,T,DEL,5311,114,113,1,2.15
barcode11,5,70946230,T,DEL,5265,9,8,1,0.17
barcode11,5,70946231,T,DEL,5248,9,8,1,0.17
barcode11,5,70946232,G,DEL,5256,11,10,1,0.21
barcode11,5,70946233,T,DEL,5259,172,141,31,3.27
barcode11,5,70946234,T,DEL,5256,5,5,0,0.1
barcode11,5,70946235,T,DEL,5244,2,2,0,0.04
barcode11,5,70946236,T,DEL,5241,1,1,0,0.02
barcode11,5,70946237,G,DEL,5240,5,2,3,0.1
barcode11,5,70946238,T,DEL,5232,8,1,7,0.15
barcode11,5,70946239,A,DEL,5188,69,55,14,1.33
barcode11,5,70946240,A,DEL,5185,1,0,1,0.02
barcode11,5,70946241,A,DEL,5165,4,3,1,0.08
barcode11,5,70946242,T,DEL,5162,83,30,53,1.61
barcode11,5,70946243,T,DEL,5150,10,10,0,0.19
barcode11,5,70946244,T,DEL,5138,31,29,2,0.6
barcode11,5,70946245,A,DEL,5090,63,61,2,1.24
barcode11,5,70946246,T,DEL,5076,5,4,1,0.1
barcode11,5,70946247,A,DEL,5035,174,96,78,3.46
barcode11,5,70946248,A,DEL,5033,3,1,2,0.06
barcode11,5,70946249,A,DEL,5021,1,1,0,0.02
barcode11,5,70946250,A,DEL,4997,4,4,0,0.08
barcode11,5,70946251,T,DEL,4994,6,6,0,0.12
barcode11,5,70946252,A,DEL,4985,6,6,0,0.12
barcode11,5,70946253,C,DEL,4978,25,25,0,0.5
barcode11,5,70946254,T,DEL,4978,1,1,0,0.02
barcode11,5,70946255,A,DEL,4972,18,18,0,0.36
barcode11,5,70946256,C,DEL,4961,7,7,0,0.14
barcode11,5,70946257,T,DEL,4959,23,22,1,0.46
barcode11,5,70946258,T,DEL,4941,3,3,0,0.06
barcode11,5,70946259,G,DEL,4935,7,7,0,0.14
barcode11,5,70946260,C,DEL,4909,26,23,3,0.53
barcode11,5,70946261,T,DEL,4909,67,62,5,1.36
barcode11,5,70946262,T,DEL,4879,78,70,8,1.6
barcode11,5,70946263,C,DEL,4857,85,75,10,1.75
barcode11,5,70946264,T,DEL,4854,1,0,1,0.02
barcode11,5,70946265,C,DEL,4821,15,14,1,0.31
barcode11,5,70946266,T,DEL,4798,23,10,13,0.48
barcode11,5,70946267,C,DEL,4748,34,27,7,0.72
barcode11,5,70946268,T,DEL,4728,486,467,19,10.28
barcode11,5,70946269,T,DEL,4705,22,4,18,0.47
barcode11,5,70946270,T,DEL,4670,20,2,18,0.43
barcode11,5,70946271,A,DEL,4623,9,9,0,0.19
barcode11,5,70946272,T,DEL,4618,8,7,1,0.17
barcode11,5,70946273,A,DEL,4550,28,27,1,0.62
barcode11,5,70946274,T,DEL,4546,24,23,1,0.53
barcode11,5,70946275,T,DEL,4541,26,25,1,0.57
barcode11,5,70946276,A,DEL,4518,86,85,1,1.9
barcode11,5,70946277,C,DEL,4511,31,30,1,0.69
barcode11,5,70946278,T,DEL,4507,3,2,1,0.07
barcode11,5,70946279,A,DEL,4445,95,69,26,2.14
barcode11,5,70946280,A,DEL,4438,7,6,1,0.16
barcode11,5,70946281,A,DEL,4423,4,2,2,0.09
barcode11,5,70946282,A,DEL,4408,3,1,2,0.07
barcode11,5,70946283,A,DEL,4397,4,2,2,0.09
barcode11,5,70946284,A,DEL,4384,5,2,3,0.11
barcode11,5,70946285,T,DEL,4379,7,4,3,0.16
barcode11,5,70946286,A,DEL,4356,140,140,0,3.21
barcode11,5,70946287,A,DEL,4355,2,2,0,0.05
barcode11,5,70946289,A,DEL,4348,2,2,0,0.05
barcode11,5,70946290,A,DEL,4330,2,2,0,0.05
barcode11,5,70946291,T,DEL,4326,4,4,0,0.09
barcode11,5,70946292,A,DEL,4246,540,526,14,12.72
barcode11,5,70946293,A,DEL,4243,144,143,1,3.39
barcode11,5,70946294,A,DEL,4206,42,41,1,1.0
barcode11,5,70946295,A,DEL,4179,4,4,0,0.1
barcode11,5,70946299,T,DEL,4066,2,2,0,0.05
barcode11,5,70946300,A,DEL,4016,1,1,0,0.02
barcode11,5,70946301,C,DEL,3990,8,8,0,0.2
barcode11,5,70946302,A,DEL,3924,5,5,0,0.13
barcode11,5,70946303,A,DEL,3908,2,2,0,0.05
barcode11,5,70946304,C,DEL,3879,3,3,0,0.08
barcode11,5,70946305,T,DEL,3874,15,15,0,0.39
barcode11,5,70946306,G,DEL,3813,17,17,0,0.45
barcode11,5,70946307,T,DEL,3795,11,11,0,0.29
barcode11,5,70946308,C,DEL,3341,13,12,1,0.39
barcode11,5,70946309,T,DEL,3330,3,0,3,0.09
barcode11,5,70946310,G,DEL,3175,2,0,2,0.06
barcode11,5,70946312,G,DEL,3022,1,1,0,0.03
barcode11,5,70946313,G,DEL,2898,1,1,0,0.03
barcode11,5,70946315,T,DEL,2626,7,7,0,0.27
barcode11,5,70946317,A,DEL,306,1,0,1,0.33
barcode11,5,70951935,T,DEL,2131,1,1,0,0.05
barcode11,5,70951938,C,DEL,3465,1,0,1,0.03
barcode11,5,70951943,T,DEL,3588,57,4,53,1.59
barcode11,5,70951946,C,DEL,3687,14,1,13,0.38
barcode11,5,70951947,A,DEL,3695,16,2,14,0.43
barcode11,5,70951948,G,DEL,3702,51,7,44,1.38
barcode11,5,70951949,A,DEL,3724,18,1,17,0.48
barcode11,5,70951950,C,DEL,3729,18,0,18,0.48
barcode11,5,70951951,A,DEL,3731,673,19,654,18.04
barcode11,5,70951952,A,DEL,3744,4,0,4,0.11
barcode11,5,70951955,T,DEL,3758,2,0,2,0.05
barcode11,5,70951956,C,DEL,3760,15,0,15,0.4
barcode11,5,70951957,A,DEL,3773,586,54,532,15.53
barcode11,5,70951958,A,DEL,3797,90,6,84,2.37
barcode11,5,70951959,A,DEL,3817,10,0,10,0.26
barcode11,5,70951960,A,DEL,3822,6,2,4,0.16
barcode11,5,70951961,A,DEL,3831,10,3,7,0.26
barcode11,5,70951962,G,DEL,3833,16,7,9,0.42
barcode11,5,70951963,A,DEL,3882,236,7,229,6.08
barcode11,5,70951964,A,DEL,3896,6,5,1,0.15
barcode11,5,70951965,G,DEL,3900,8,6,2,0.21
barcode11,5,70951966,G,DEL,3915,3,2,1,0.08
barcode11,5,70951967,A,DEL,3961,257,5,252,6.49
barcode11,5,70951969,G,DEL,3975,3,2,1,0.08
barcode11,5,70951971,T,DEL,3996,2,0,2,0.05
barcode11,5,70951972,G,DEL,4017,3,0,3,0.07
barcode11,5,70951973,C,DEL,4042,57,1,56,1.41
barcode11,5,70951974,T,DEL,4065,2,0,2,0.05
barcode11,5,70951975,C,DEL,4092,32,0,32,0.78
barcode11,5,70951976,A,DEL,4100,33,0,33,0.8
barcode11,5,70951977,C,DEL,4122,9,4,5,0.22
barcode11,5,70951978,A,DEL,4127,17,1,16,0.41
barcode11,5,70951979,T,DEL,4147,16,3,13,0.39
barcode11,5,70951980,T,DEL,4156,5,0,5,0.12
barcode11,5,70951981,C,DEL,4170,11,1,10,0.26
barcode11,5,70951982,C,DEL,4199,8,0,8,0.19
barcode11,5,70951983,T,DEL,4218,69,25,44,1.64
barcode11,5,70951984,T,DEL,4239,33,1,32,0.78
barcode11,5,70951985,A,DEL,4252,64,35,29,1.51
barcode11,5,70951988,T,DEL,4271,2,0,2,0.05
barcode11,5,70951990,A,DEL,4310,76,0,76,1.76
barcode11,5,70951992,G,DEL,4336,2,2,0,0.05
barcode11,5,70951993,G,DEL,4366,2,2,0,0.05
barcode11,5,70951994,A,DEL,4400,18,10,8,0.41
barcode11,5,70951995,G,DEL,4408,47,6,41,1.07
barcode11,5,70951996,T,DEL,4417,19,0,19,0.43
barcode11,5,70951997,A,DEL,4431,13,0,13,0.29
barcode11,5,70951998,A,DEL,4440,1,0,1,0.02
barcode11,5,70952000,T,DEL,4483,9,7,2,0.2
barcode11,5,70952001,C,DEL,4495,48,15,33,1.07
barcode11,5,70952002,T,DEL,4560,29,1,28,0.64
barcode11,5,70952003,G,DEL,4766,18,1,17,0.38
barcode11,5,70952004,C,DEL,4875,73,41,32,1.5
barcode11,5,70952005,C,DEL,4862,30,0,30,0.62
barcode11,5,70952006,A,DEL,4906,2,2,0,0.04
barcode11,5,70952007,G,DEL,4928,16,0,16,0.32
barcode11,5,70952008,C,DEL,4887,3,0,3,0.06
barcode11,5,70952009,A,DEL,4875,1,0,1,0.02
barcode11,5,70952010,T,DEL,4876,15,12,3,0.31
barcode11,5,70952011,T,DEL,4884,8,7,1,0.16
barcode11,5,70952012,A,DEL,4933,12,7,5,0.24
barcode11,5,70952013,T,DEL,4936,4,0,4,0.08
barcode11,5,70952014,G,DEL,4948,8,0,8,0.16
barcode11,5,70952015,A,DEL,4982,723,91,632,14.51
barcode11,5,70952017,A,DEL,4962,1,1,0,0.02
barcode11,5,70952018,G,DEL,4962,1,1,0,0.02
barcode11,5,70952019,T,DEL,4972,3,1,2,0.06
barcode11,5,70952020,G,DEL,4968,4,0,4,0.08
barcode11,5,70952021,A,DEL,4991,3,0,3,0.06
barcode11,5,70952022,A,DEL,5000,3,0,3,0.06
barcode11,5,70952023,T,DEL,4980,14,5,9,0.28
barcode11,5,70952024,C,DEL,4987,9,5,4,0.18
barcode11,5,70952025,T,DEL,4991,17,16,1,0.34
barcode11,5,70952026,T,DEL,4992,3,2,1,0.06
barcode11,5,70952027,A,DEL,5024,7,4,3,0.14
barcode11,5,70952028,C,DEL,5011,7,4,3,0.14
barcode11,5,70952029,T,DEL,5023,423,31,392,8.42
barcode11,5,70952030,T,DEL,5016,1,0,1,0.02
barcode11,5,70952031,T,DEL,5020,18,17,1,0.36
barcode11,5,70952032,T,DEL,5011,28,27,1,0.56
barcode11,5,70952033,G,DEL,5049,39,37,2,0.77
barcode11,5,70952034,T,DEL,5043,144,4,140,2.86
barcode11,5,70952035,A,DEL,5036,38,12,26,0.75
barcode11,5,70952036,A,DEL,5034,8,0,8,0.16
barcode11,5,70952037,A,DEL,5040,2,0,2,0.04
barcode11,5,70952038,A,DEL,5020,1,0,1,0.02
barcode11,5,70952039,C,DEL,5013,2,0,2,0.04
barcode11,5,70952040,T,DEL,5028,10,5,5,0.2
barcode11,5,70952041,T,DEL,5031,2,0,2,0.04
barcode11,5,70952042,T,DEL,5036,2,0,2,0.04
barcode11,5,70952044,T,DEL,5067,2,0,2,0.04
barcode11,5,70952045,G,DEL,5060,4,2,2,0.08
barcode11,5,70952046,G,DEL,5038,1,0,1,0.02
barcode11,5,70952047,T,DEL,5057,21,1,20,0.42
barcode11,5,70952049,T,DEL,5068,3,0,3,0.06
barcode11,5,70952050,G,DEL,5210,10,5,5,0.19
barcode11,5,70952051,T,DEL,5229,2,0,2,0.04
barcode11,5,70952052,G,DEL,5233,48,42,6,0.92
barcode11,5,70952053,G,DEL,5229,4,0,4,0.08
barcode11,5,70952054,A,DEL,5235,38,1,37,0.73
barcode11,5,70952055,A,DEL,5146,4,0,4,0.08
barcode11,5,70952056,A,DEL,5128,3,0,3,0.06
barcode11,5,70952057,A,DEL,5123,3,0,3,0.06
barcode11,5,70952058,C,DEL,5118,10,0,10,0.2
barcode11,5,70952059,A,DEL,5117,292,0,292,5.71
barcode11,5,70952060,A,DEL,5109,3,0,3,0.06
barcode11,5,70952061,A,DEL,5107,5,3,2,0.1
barcode11,5,70952062,T,DEL,5107,7,5,2,0.14
barcode11,5,70952063,G,DEL,5095,8,4,4,0.16
barcode11,5,70952064,T,DEL,5089,266,56,210,5.23
barcode11,5,70952065,T,DEL,5097,23,0,23,0.45
barcode11,5,70952069,G,DEL,5099,21,2,19,0.41
barcode11,5,70952070,A,DEL,5196,40,0,40,0.77
barcode11,5,70952071,A,DEL,5180,4,2,2,0.08
barcode11,5,70952072,C,DEL,5183,10,8,2,0.19
barcode11,5,70952073,A,DEL,5188,1,1,0,0.02
barcode11,5,70952074,T,DEL,5189,38,22,16,0.73
barcode11,5,70952075,T,DEL,5188,2,2,0,0.04
barcode11,5,70952076,T,DEL,5177,16,0,16,0.31
barcode11,5,70952077,A,DEL,5212,521,12,509,10.0
barcode11,5,70952078,A,DEL,5243,105,0,105,2.0
barcode11,5,70952079,A,DEL,5241,6,0,6,0.11
barcode11,5,70952080,A,DEL,5224,1,0,1,0.02
barcode11,5,70952081,A,DEL,5219,4,0,4,0.08
barcode11,5,70952082,G,DEL,5216,14,0,14,0.27
barcode11,5,70952083,T,DEL,5235,105,105,0,2.01
barcode11,5,70952084,T,DEL,5255,21,21,0,0.4
barcode11,5,70952085,C,DEL,5252,84,60,24,1.6
barcode11,5,70952086,A,DEL,5258,131,1,130,2.49
barcode11,5,70952087,G,DEL,5244,141,3,138,2.69
barcode11,5,70952088,A,DEL,5238,5,3,2,0.1
barcode11,5,70952089,T,DEL,5240,2,0,2,0.04
barcode11,5,70952090,G,DEL,5296,2,1,1,0.04
barcode11,5,70952091,T,DEL,5288,77,73,4,1.46
barcode11,5,70952092,T,DEL,5415,5,1,4,0.09
barcode11,5,70952093,A,DEL,5474,199,6,193,3.64
barcode11,5,70952094,A,DEL,5400,27,1,26,0.5
barcode11,5,70952095,A,DEL,5419,3,1,2,0.06
barcode11,5,70952096,A,DEL,5408,2,1,1,0.04
barcode11,5,70952097,A,DEL,5394,6,1,5,0.11
barcode11,5,70952098,G,DEL,5365,11,4,7,0.21
barcode11,5,70952099,T,DEL,5379,36,28,8,0.67
barcode11,5,70952100,T,DEL,5368,2,0,2,0.04
barcode11,5,70952101,G,DEL,5378,14,0,14,0.26
barcode11,5,70952102,A,DEL,5532,389,4,385,7.03
barcode11,5,70952103,A,DEL,5543,4,0,4,0.07
barcode11,5,70952105,G,DEL,5522,6,1,5,0.11
barcode11,5,70952107,T,DEL,5578,16,16,0,0.29
barcode11,5,70952109,A,DEL,5582,14,0,14,0.25
barcode11,5,70952111,T,DEL,5579,9,2,7,0.16
barcode11,5,70952112,G,DEL,5582,5,2,3,0.09
barcode11,5,70952113,T,DEL,5555,128,4,124,2.3
barcode11,5,70952114,A,DEL,5546,53,8,45,0.96
barcode11,5,70952115,A,DEL,5541,5,0,5,0.09
barcode11,5,70952116,A,DEL,5604,3,0,3,0.05
barcode11,5,70952117,A,DEL,5573,3,0,3,0.05
barcode11,5,70952118,C,DEL,5559,6,1,5,0.11
barcode11,5,70952119,A,DEL,5409,2,1,1,0.04
barcode11,5,70952120,A,DEL,5429,2,2,0,0.04
barcode11,5,70952121,T,DEL,5425,2,2,0,0.04
barcode11,5,70952122,C,DEL,5269,5,2,3,0.09
barcode11,5,70952123,A,DEL,5262,13,0,13,0.25
barcode11,5,70952124,A,DEL,5254,1,1,0,0.02
barcode11,5,70952125,T,DEL,5246,2,2,0,0.04
barcode11,5,70952126,A,DEL,5186,12,8,4,0.23
barcode11,5,70952127,T,DEL,5188,52,52,0,1.0
barcode11,5,70952129,A,DEL,5188,48,4,44,0.93
barcode11,5,70952132,G,DEL,5158,10,9,1,0.19
barcode11,5,70952133,A,DEL,5141,11,8,3,0.21
barcode11,5,70952134,A,DEL,5137,9,1,8,0.18
barcode11,5,70952135,T,DEL,5094,525,273,252,10.31
barcode11,5,70952136,T,DEL,5092,1,0,1,0.02
barcode11,5,70952137,T,DEL,5079,1,1,0,0.02
barcode11,5,70952138,T,DEL,5066,2,1,1,0.04
barcode11,5,70952139,G,DEL,5052,3,2,1,0.06
barcode11,5,70952140,A,DEL,5061,2,0,2,0.04
barcode11,5,70952143,C,DEL,5043,91,78,13,1.8
barcode11,5,70952144,C,DEL,5024,8,0,8,0.16
barcode11,5,70952145,A,DEL,4986,58,16,42,1.16
barcode11,5,70952148,A,DEL,4931,1,1,0,0.02
barcode11,5,70952149,C,DEL,4923,1,1,0,0.02
barcode11,5,70952150,T,DEL,4919,3,2,1,0.06
barcode11,5,70952151,A,DEL,4886,3,2,1,0.06
barcode11,5,70952152,T,DEL,4883,32,31,1,0.66
barcode11,5,70952154,A,DEL,4792,8,1,7,0.17
barcode11,5,70952155,G,DEL,4783,21,11,10,0.44
barcode11,5,70952156,A,DEL,4758,2,1,1,0.04
barcode11,5,70952157,T,DEL,4758,3,1,2,0.06
barcode11,5,70952158,A,DEL,4712,122,68,54,2.59
barcode11,5,70952159,A,DEL,4702,8,0,8,0.17
barcode11,5,70952160,A,DEL,4696,1,0,1,0.02
barcode11,5,70952162,G,DEL,4651,1,1,0,0.02
barcode11,5,70952164,T,DEL,4633,27,27,0,0.58
barcode11,5,70952165,T,DEL,4611,2,2,0,0.04
barcode11,5,70952166,A,DEL,4560,2,2,0,0.04
barcode11,5,70952167,A,DEL,4547,2,2,0,0.04
barcode11,5,70952168,T,DEL,4526,5,1,4,0.11
barcode11,5,70952169,C,DEL,4456,6,0,6,0.13
barcode11,5,70952170,T,DEL,4437,43,0,43,0.97
barcode11,5,70952171,A,DEL,4355,9,1,8,0.21
barcode11,5,70952172,C,DEL,4298,4,1,3,0.09
barcode11,5,70952173,A,DEL,4237,4,1,3,0.09
barcode11,5,70952174,T,DEL,4232,22,1,21,0.52
barcode11,5,70952175,C,DEL,4190,58,44,14,1.38
barcode11,5,70952177,C,DEL,4158,3,3,0,0.07
barcode11,5,70952178,T,DEL,4074,46,3,43,1.13
barcode11,5,70952179,A,DEL,3988,18,18,0,0.45
barcode11,5,70952180,C,DEL,3926,2,2,0,0.05
barcode11,5,70952182,A,DEL,3768,11,11,0,0.29
barcode11,5,70952183,G,DEL,3750,11,11,0,0.29
barcode11,5,70952184,A,DEL,3715,10,0,10,0.27
barcode11,5,70952185,A,DEL,3693,1,0,1,0.03
barcode11,5,70952186,T,DEL,3668,2,2,0,0.05
barcode11,5,70952187,T,DEL,3646,1,0,1,0.03
barcode11,5,70952188,C,DEL,3595,7,2,5,0.19
barcode11,5,70952189,T,DEL,3515,5,1,4,0.14
barcode11,5,70952190,C,DEL,3464,23,1,22,0.66
barcode11,5,70952191,A,DEL,3429,1,1,0,0.03
barcode11,5,70952192,T,DEL,3394,1,1,0,0.03
barcode11,5,70952193,A,DEL,3303,18,18,0,0.54
barcode11,5,70952194,C,DEL,2852,6,3,3,0.21
barcode11,5,70952195,T,DEL,2806,31,27,4,1.1
barcode11,5,70952196,T,DEL,2396,1,1,0,0.04
barcode11,5,70952197,A,DEL,2380,1,1,0,0.04
barcode11,5,70952198,A,DEL,2374,1,1,0,0.04
barcode11,5,70952200,T,DEL,2337,1,1,0,0.04
barcode11,5,70952201,G,DEL,2241,1,1,0,0.04
barcode11,5,70952202,G,DEL,2217,1,1,0,0.05
barcode11,5,70952203,T,DEL,2209,4,4,0,0.18
barcode11,5,70952207,T,DEL,2014,1,1,0,0.05
barcode11,5,70953445,C,DEL,1,1,1,0,100.0
barcode11,5,70953481,T,DEL,1,1,1,0,100.0
barcode11,5,70955315,A,DEL,1,1,0,1,100.0
barcode11,5,70956017,A,DEL,1,1,0,1,100.0
barcode11,5,70956122,T,DEL,1,1,0,1,100.0
barcode11,5,70956259,C,DEL,1,1,0,1,100.0
barcode11,5,70956260,C,DEL,1,1,0,1,100.0
barcode11,5,70956261,C,DEL,1,1,0,1,100.0
barcode11,5,70956277,T,DEL,1,1,0,1,100.0
barcode14,5,70924453,G,DEL,5,2,0,2,40.0
barcode14,5,70924454,G,DEL,5,1,0,1,20.0
barcode14,5,70924479,A,DEL,5,1,0,1,20.0
barcode14,5,70924484,T,DEL,5,1,0,1,20.0
barcode14,5,70924485,C,DEL,5,1,0,1,20.0
barcode14,5,70924486,T,DEL,5,1,0,1,20.0
barcode14,5,70924487,G,DEL,5,4,0,4,80.0
barcode14,5,70924488,C,DEL,5,5,0,5,100.0
barcode14,5,70924489,C,DEL,5,5,0,5,100.0
barcode14,5,70924490,G,DEL,5,2,0,2,40.0
barcode14,5,70924491,C,DEL,5,2,0,2,40.0
barcode14,5,70924492,C,DEL,5,1,0,1,20.0
barcode14,5,70924493,T,DEL,5,1,0,1,20.0
barcode14,5,70924494,T,DEL,5,1,0,1,20.0
barcode14,5,70924516,C,DEL,7,1,0,1,14.29
barcode14,5,70924543,A,DEL,8,1,0,1,12.5
barcode14,5,70924554,A,DEL,10,2,0,2,20.0
barcode14,5,70924570,C,DEL,10,1,0,1,10.0
barcode14,5,70924588,A,DEL,10,1,0,1,10.0
barcode14,5,70924589,G,DEL,10,7,1,6,70.0
barcode14,5,70924595,G,DEL,11,4,1,3,36.36
barcode14,5,70924611,A,DEL,11,2,1,1,18.18
barcode14,5,70924612,C,DEL,11,2,1,1,18.18
barcode14,5,70924613,A,DEL,11,1,1,0,9.09
barcode14,5,70924614,C,DEL,11,1,1,0,9.09
barcode14,5,70924616,C,DEL,11,1,0,1,9.09
barcode14,5,70924640,C,DEL,12,1,0,1,8.33
barcode14,5,70924667,G,DEL,11,1,0,1,9.09
barcode14,5,70924668,C,DEL,11,1,0,1,9.09
barcode14,5,70924670,T,DEL,11,1,1,0,9.09
barcode14,5,70924700,A,DEL,13,3,0,3,23.08
barcode14,5,70924704,A,DEL,13,1,1,0,7.69
barcode14,5,70924705,C,DEL,13,1,1,0,7.69
barcode14,5,70924706,A,DEL,13,1,0,1,7.69
barcode14,5,70924716,T,DEL,14,1,0,1,7.14
barcode14,5,70924732,C,DEL,15,1,0,1,6.67
barcode14,5,70924733,G,DEL,15,1,0,1,6.67
barcode14,5,70924744,T,DEL,15,1,0,1,6.67
barcode14,5,70924752,G,DEL,15,5,0,5,33.33
barcode14,5,70924766,G,DEL,14,2,0,2,14.29
barcode14,5,70924785,A,DEL,16,4,3,1,25.0
barcode14,5,70924814,C,DEL,14,1,1,0,7.14
barcode14,5,70924815,G,DEL,14,1,1,0,7.14
barcode14,5,70924816,C,DEL,14,1,1,0,7.14
barcode14,5,70924817,G,DEL,14,1,1,0,7.14
barcode14,5,70924818,C,DEL,14,1,1,0,7.14
barcode14,5,70924834,T,DEL,14,1,0,1,7.14
barcode14,5,70924835,G,DEL,14,1,0,1,7.14
barcode14,5,70924843,G,DEL,14,2,2,0,14.29
barcode14,5,70924844,G,DEL,15,1,1,0,6.67
barcode14,5,70924845,G,DEL,15,1,1,0,6.67
barcode14,5,70924846,C,DEL,15,1,1,0,6.67
barcode14,5,70924859,C,DEL,386,1,0,1,0.26
barcode14,5,70924860,A,DEL,425,23,0,23,5.41
barcode14,5,70924864,C,DEL,749,1,0,1,0.13
barcode14,5,70924865,A,DEL,799,7,1,6,0.88
barcode14,5,70924866,A,DEL,804,2,0,2,0.25
barcode14,5,70924867,A,DEL,812,2,0,2,0.25
barcode14,5,70924868,C,DEL,832,9,0,9,1.08
barcode14,5,70924869,A,DEL,856,9,0,9,1.05
barcode14,5,70924870,A,DEL,860,1,1,0,0.12
barcode14,5,70924871,A,DEL,861,6,2,4,0.7
barcode14,5,70924872,C,DEL,863,20,2,18,2.32
barcode14,5,70924873,A,DEL,866,266,30,236,30.72
barcode14,5,70924874,A,DEL,873,111,7,104,12.71
barcode14,5,70924875,A,DEL,878,36,0,36,4.1
barcode14,5,70924876,A,DEL,881,7,0,7,0.79
barcode14,5,70924877,A,DEL,881,4,0,4,0.45
barcode14,5,70924878,A,DEL,887,1,0,1,0.11
barcode14,5,70924879,A,DEL,894,1,0,1,0.11
barcode14,5,70924880,A,DEL,901,1,0,1,0.11
barcode14,5,70924881,A,DEL,903,2,1,1,0.22
barcode14,5,70924882,A,DEL,906,4,1,3,0.44
barcode14,5,70924883,G,DEL,908,4,1,3,0.44
barcode14,5,70924884,G,DEL,913,3,1,2,0.33
barcode14,5,70924885,A,DEL,925,44,0,44,4.76
barcode14,5,70924890,A,DEL,959,17,1,16,1.77
barcode14,5,70924891,A,DEL,959,3,0,3,0.31
barcode14,5,70924892,A,DEL,960,2,2,0,0.21
barcode14,5,70924893,T,DEL,960,2,2,0,0.21
barcode14,5,70924895,T,DEL,979,3,0,3,0.31
barcode14,5,70924896,A,DEL,1000,6,0,6,0.6
barcode14,5,70924903,T,DEL,1191,2,0,2,0.17
barcode14,5,70924904,G,DEL,1199,1,0,1,0.08
barcode14,5,70924905,A,DEL,1204,28,0,28,2.33
barcode14,5,70924906,A,DEL,1216,1,0,1,0.08
barcode14,5,70924907,A,DEL,1218,1,0,1,0.08
barcode14,5,70924908,T,DEL,1218,1,0,1,0.08
barcode14,5,70924909,G,DEL,1228,1,0,1,0.08
barcode14,5,70924910,A,DEL,1248,29,0,29,2.32
barcode14,5,70924911,A,DEL,1257,4,0,4,0.32
barcode14,5,70924912,A,DEL,1258,1,0,1,0.08
barcode14,5,70924913,G,DEL,1259,1,0,1,0.08
barcode14,5,70924914,G,DEL,1260,1,0,1,0.08
barcode14,5,70924915,A,DEL,1271,1,1,0,0.08
barcode14,5,70924916,T,DEL,1274,14,14,0,1.1
barcode14,5,70924917,T,DEL,1285,1,1,0,0.08
barcode14,5,70924918,G,DEL,1295,14,14,0,1.08
barcode14,5,70924919,A,DEL,1338,8,8,0,0.6
barcode14,5,70924920,G,DEL,1349,4,2,2,0.3
barcode14,5,70924921,A,DEL,1364,3,1,2,0.22
barcode14,5,70924922,G,DEL,1367,7,0,7,0.51
barcode14,5,70924923,A,DEL,1370,6,4,2,0.44
barcode14,5,70924924,A,DEL,1374,2,2,0,0.15
barcode14,5,70924926,T,DEL,1375,1,1,0,0.07
barcode14,5,70924927,G,DEL,1380,3,0,3,0.22
barcode14,5,70924928,A,DEL,1390,74,9,65,5.32
barcode14,5,70924929,A,DEL,1399,5,1,4,0.36
barcode14,5,70924930,A,DEL,1399,1,1,0,0.07
barcode14,5,70924931,A,DEL,1401,4,4,0,0.29
barcode14,5,70924932,A,DEL,1403,4,4,0,0.29
barcode14,5,70924933,T,DEL,1403,7,4,3,0.5
barcode14,5,70924934,A,DEL,1416,1,1,0,0.07
barcode14,5,70924936,A,DEL,1443,5,2,3,0.35
barcode14,5,70924937,C,DEL,1450,4,1,3,0.28
barcode14,5,70924938,A,DEL,1457,1,0,1,0.07
barcode14,5,70924939,C,DEL,1460,1,0,1,0.07
barcode14,5,70924941,C,DEL,1491,8,3,5,0.54
barcode14,5,70924942,C,DEL,1494,7,2,5,0.47
barcode14,5,70924943,A,DEL,1507,6,3,3,0.4
barcode14,5,70924944,C,DEL,1516,9,3,6,0.59
barcode14,5,70924945,A,DEL,1511,27,10,17,1.79
barcode14,5,70924946,A,DEL,1520,1,1,0,0.07
barcode14,5,70924947,A,DEL,1525,2,1,1,0.13
barcode14,5,70924948,T,DEL,1525,4,2,2,0.26
barcode14,5,70924949,G,DEL,1536,5,2,3,0.33
barcode14,5,70924950,T,DEL,1540,6,4,2,0.39
barcode14,5,70924951,G,DEL,1545,357,23,334,23.11
barcode14,5,70924952,G,DEL,1557,1,0,1,0.06
barcode14,5,70924953,G,DEL,1555,2,0,2,0.13
barcode14,5,70924954,A,DEL,1577,3,1,2,0.19
barcode14,5,70924955,G,DEL,1581,8,2,6,0.51
barcode14,5,70924956,G,DEL,1595,1,0,1,0.06
barcode14,5,70924957,G,DEL,1601,1,0,1,0.06
barcode14,5,70924958,C,DEL,1600,1,1,0,0.06
barcode14,5,70924959,G,DEL,1601,3,0,3,0.19
barcode14,5,70924962,A,DEL,1623,12,2,10,0.74
barcode14,5,70924963,A,DEL,1627,1,1,0,0.06
barcode14,5,70924964,C,DEL,1628,1,1,0,0.06
barcode14,5,70924965,C,DEL,1639,1,1,0,0.06
barcode14,5,70924966,A,DEL,1642,1,1,0,0.06
barcode14,5,70924967,C,DEL,1644,7,0,7,0.43
barcode14,5,70924968,T,DEL,1647,37,3,34,2.25
barcode14,5,70924969,C,DEL,1662,11,0,11,0.66
barcode14,5,70924970,G,DEL,1656,13,1,12,0.79
barcode14,5,70924971,T,DEL,1658,34,1,33,2.05
barcode14,5,70924972,A,DEL,1665,19,1,18,1.14
barcode14,5,70924973,G,DEL,1664,24,4,20,1.44
barcode14,5,70924974,A,DEL,1690,12,0,12,0.71
barcode14,5,70924975,A,DEL,1697,1,0,1,0.06
barcode14,5,70924978,C,DEL,1701,1,1,0,0.06
barcode14,5,70924979,G,DEL,1703,2,1,1,0.12
barcode14,5,70924980,T,DEL,1701,1,0,1,0.06
barcode14,5,70924981,G,DEL,1706,25,21,4,1.47
barcode14,5,70924982,A,DEL,1708,4,1,3,0.23
barcode14,5,70924983,G,DEL,1713,11,6,5,0.64
barcode14,5,70924984,A,DEL,1712,16,7,9,0.93
barcode14,5,70924985,A,DEL,1721,2,2,0,0.12
barcode14,5,70924987,T,DEL,1720,1,1,0,0.06
barcode14,5,70924988,T,DEL,1725,14,14,0,0.81
barcode14,5,70924989,A,DEL,1731,15,15,0,0.87
barcode14,5,70924990,C,DEL,1730,15,14,1,0.87
barcode14,5,70924992,A,DEL,1748,5,1,4,0.29
barcode14,5,70924993,C,DEL,1750,5,1,4,0.29
barcode14,5,70924994,A,DEL,1752,8,6,2,0.46
barcode14,5,70924996,G,DEL,1767,4,2,2,0.23
barcode14,5,70924998,G,DEL,1767,1,0,1,0.06
barcode14,5,70925000,T,DEL,1773,84,0,84,4.74
barcode14,5,70925001,C,DEL,1769,92,1,91,5.2
barcode14,5,70925002,C,DEL,1773,11,0,11,0.62
barcode14,5,70925003,T,DEL,1784,11,0,11,0.62
barcode14,5,70925004,C,DEL,1797,146,122,24,8.12
barcode14,5,70925007,G,DEL,1812,4,3,1,0.22
barcode14,5,70925011,A,DEL,1819,1,1,0,0.05
barcode14,5,70925012,C,DEL,1824,2,2,0,0.11
barcode14,5,70925013,C,DEL,1821,1,0,1,0.05
barcode14,5,70925014,G,DEL,1818,3,0,3,0.17
barcode14,5,70925015,T,DEL,1815,4,0,4,0.22
barcode14,5,70925016,A,DEL,1820,2,2,0,0.11
barcode14,5,70925017,C,DEL,1826,5,5,0,0.27
barcode14,5,70925020,T,DEL,1833,100,4,96,5.46
barcode14,5,70925022,C,DEL,1847,12,3,9,0.65
barcode14,5,70925024,G,DEL,1848,2,0,2,0.11
barcode14,5,70925025,C,DEL,1847,3,1,2,0.16
barcode14,5,70925026,T,DEL,1851,3,3,0,0.16
barcode14,5,70925027,C,DEL,1860,272,259,13,14.62
barcode14,5,70925029,C,DEL,1869,1,1,0,0.05
barcode14,5,70925030,A,DEL,1869,4,3,1,0.21
barcode14,5,70925031,G,DEL,1870,3,0,3,0.16
barcode14,5,70925032,A,DEL,1868,3,1,2,0.16
barcode14,5,70925033,A,DEL,1868,1,0,1,0.05
barcode14,5,70925034,G,DEL,1867,1,0,1,0.05
barcode14,5,70925035,C,DEL,1868,253,190,63,13.54
barcode14,5,70925036,C,DEL,1869,6,4,2,0.32
barcode14,5,70925037,C,DEL,1877,2,1,1,0.11
barcode14,5,70925038,C,DEL,1874,29,27,2,1.55
barcode14,5,70925039,G,DEL,1876,87,57,30,4.64
barcode14,5,70925040,G,DEL,1876,3,3,0,0.16
barcode14,5,70925041,G,DEL,1868,2,2,0,0.11
barcode14,5,70925045,C,DEL,1885,1,0,1,0.05
barcode14,5,70925046,G,DEL,1886,13,10,3,0.69
barcode14,5,70925047,G,DEL,1892,1,0,1,0.05
barcode14,5,70925048,A,DEL,1891,161,5,156,8.51
barcode14,5,70925052,C,DEL,1885,1,0,1,0.05
barcode14,5,70925053,G,DEL,1890,1,0,1,0.05
barcode14,5,70925057,C,DEL,1890,2,0,2,0.11
barcode14,5,70925058,T,DEL,1887,2,2,0,0.11
barcode14,5,70925059,C,DEL,1889,6,3,3,0.32
barcode14,5,70925060,T,DEL,1891,70,47,23,3.7
barcode14,5,70925061,T,DEL,1891,11,2,9,0.58
barcode14,5,70925062,A,DEL,1886,41,7,34,2.17
barcode14,5,70925063,A,DEL,1883,3,1,2,0.16
barcode14,5,70925064,G,DEL,1880,3,1,2,0.16
barcode14,5,70925065,A,DEL,1883,51,36,15,2.71
barcode14,5,70925066,A,DEL,1878,10,8,2,0.53
barcode14,5,70925067,G,DEL,1877,56,38,18,2.98
barcode14,5,70925068,G,DEL,1866,2,2,0,0.11
barcode14,5,70925070,A,DEL,1851,3,2,1,0.16
barcode14,5,70925071,C,DEL,1833,4,2,2,0.22
barcode14,5,70925072,G,DEL,1831,87,74,13,4.75
barcode14,5,70925073,G,DEL,1824,5,3,2,0.27
barcode14,5,70925074,G,DEL,1819,4,4,0,0.22
barcode14,5,70925075,G,DEL,1799,63,63,0,3.5
barcode14,5,70925076,C,DEL,1799,123,116,7,6.84
barcode14,5,70925077,C,DEL,1815,53,51,2,2.92
barcode14,5,70925078,C,DEL,1817,48,48,0,2.64
barcode14,5,70925079,C,DEL,1819,15,14,1,0.82
barcode14,5,70925080,A,DEL,1814,29,23,6,1.6
barcode14,5,70925081,C,DEL,1822,1,1,0,0.05
barcode14,5,70925082,G,DEL,1824,5,4,1,0.27
barcode14,5,70925083,C,DEL,1829,2,2,0,0.11
barcode14,5,70925084,T,DEL,1829,8,4,4,0.44
barcode14,5,70925085,G,DEL,1829,17,15,2,0.93
barcode14,5,70925086,C,DEL,1831,11,10,1,0.6
barcode14,5,70925087,G,DEL,1826,2,1,1,0.11
barcode14,5,70925088,C,DEL,1825,13,3,10,0.71
barcode14,5,70925089,A,DEL,1816,7,6,1,0.39
barcode14,5,70925090,C,DEL,1813,20,16,4,1.1
barcode14,5,70925091,C,DEL,1806,2,2,0,0.11
barcode14,5,70925092,C,DEL,1799,12,12,0,0.67
barcode14,5,70925093,G,DEL,1810,12,12,0,0.66
barcode14,5,70925094,C,DEL,1807,1,0,1,0.06
barcode14,5,70925095,G,DEL,1807,13,2,11,0.72
barcode14,5,70925097,G,DEL,1803,2,2,0,0.11
barcode14,5,70925098,T,DEL,1806,8,8,0,0.44
barcode14,5,70925099,T,DEL,1802,1,1,0,0.06
barcode14,5,70925100,T,DEL,1803,1,1,0,0.06
barcode14,5,70925101,G,DEL,1803,2,2,0,0.11
barcode14,5,70925102,C,DEL,1802,5,3,2,0.28
barcode14,5,70925103,T,DEL,1797,3,1,2,0.17
barcode14,5,70925104,A,DEL,1792,1,1,0,0.06
barcode14,5,70925108,C,DEL,1777,1,0,1,0.06
barcode14,5,70925109,G,DEL,1772,6,0,6,0.34
barcode14,5,70925110,A,DEL,1773,6,0,6,0.34
barcode14,5,70925112,G,DEL,1770,3,3,0,0.17
barcode14,5,70925113,A,DEL,1769,10,5,5,0.57
barcode14,5,70925114,G,DEL,1766,24,2,22,1.36
barcode14,5,70925115,C,DEL,1766,20,1,19,1.13
barcode14,5,70925117,G,DEL,1768,5,3,2,0.28
barcode14,5,70925118,C,DEL,1762,5,3,2,0.28
barcode14,5,70925119,G,DEL,1758,5,3,2,0.28
barcode14,5,70925120,G,DEL,1751,1,0,1,0.06
barcode14,5,70925121,C,DEL,1747,1,0,1,0.06
barcode14,5,70925122,G,DEL,1724,1,1,0,0.06
barcode14,5,70925124,C,DEL,1693,2,2,0,0.12
barcode14,5,70925125,A,DEL,1679,21,21,0,1.25
barcode14,5,70925126,G,DEL,1677,20,20,0,1.19
barcode14,5,70925127,T,DEL,1677,19,19,0,1.13
barcode14,5,70925128,G,DEL,1675,3,2,1,0.18
barcode14,5,70925129,G,DEL,1668,3,2,1,0.18
barcode14,5,70925130,T,DEL,1668,2,2,0,0.12
barcode14,5,70925131,G,DEL,1665,13,12,1,0.78
barcode14,5,70925132,G,DEL,1664,11,10,1,0.66
barcode14,5,70925133,C,DEL,1657,12,10,2,0.72
barcode14,5,70925134,G,DEL,1652,11,3,8,0.67
barcode14,5,70925135,G,DEL,1641,4,4,0,0.24
barcode14,5,70925136,C,DEL,1631,7,5,2,0.43
barcode14,5,70925137,G,DEL,1628,2,1,1,0.12
barcode14,5,70925138,T,DEL,1621,3,3,0,0.19
barcode14,5,70925139,C,DEL,1616,71,63,8,4.39
barcode14,5,70925140,C,DEL,1616,3,1,2,0.19
barcode14,5,70925141,C,DEL,1610,4,2,2,0.25
barcode14,5,70925142,G,DEL,1606,24,18,6,1.49
barcode14,5,70925143,G,DEL,1603,7,1,6,0.44
barcode14,5,70925144,A,DEL,1594,5,4,1,0.31
barcode14,5,70925145,G,DEL,1589,24,8,16,1.51
barcode14,5,70925146,C,DEL,1587,10,5,5,0.63
barcode14,5,70925147,A,DEL,1578,25,25,0,1.58
barcode14,5,70925148,G,DEL,1577,18,18,0,1.14
barcode14,5,70925149,G,DEL,1570,18,18,0,1.15
barcode14,5,70925150,A,DEL,1559,18,18,0,1.15
barcode14,5,70925151,G,DEL,1555,20,19,1,1.29
barcode14,5,70925152,G,DEL,1546,35,34,1,2.26
barcode14,5,70925153,A,DEL,1542,35,34,1,2.27
barcode14,5,70925154,T,DEL,1542,62,55,7,4.02
barcode14,5,70925155,T,DEL,1530,2,0,2,0.13
barcode14,5,70925156,C,DEL,1529,2,0,2,0.13
barcode14,5,70925158,G,DEL,1520,2,0,2,0.13
barcode14,5,70925159,T,DEL,1515,2,0,2,0.13
barcode14,5,70925160,G,DEL,1464,2,1,1,0.14
barcode14,5,70925161,C,DEL,1463,3,3,0,0.21
barcode14,5,70925162,T,DEL,1463,3,0,3,0.21
barcode14,5,70925164,T,DEL,1454,24,22,2,1.65
barcode14,5,70925166,C,DEL,1435,9,3,6,0.63
barcode14,5,70925167,C,DEL,1427,15,4,11,1.05
barcode14,5,70925168,G,DEL,1419,41,9,32,2.89
barcode14,5,70925169,G,DEL,1410,5,4,1,0.35
barcode14,5,70925170,C,DEL,1390,1,1,0,0.07
barcode14,5,70925171,G,DEL,1364,4,4,0,0.29
barcode14,5,70925172,C,DEL,1359,2,2,0,0.15
barcode14,5,70925173,G,DEL,1346,2,2,0,0.15
barcode14,5,70925175,C,DEL,1334,5,5,0,0.37
barcode14,5,70925176,A,DEL,1325,10,10,0,0.75
barcode14,5,70925177,C,DEL,1322,5,5,0,0.38
barcode14,5,70925178,A,DEL,1321,12,12,0,0.91
barcode14,5,70925179,G,DEL,1321,5,5,0,0.38
barcode14,5,70925181,C,DEL,1315,23,23,0,1.75
barcode14,5,70925182,C,DEL,1311,1,1,0,0.08
barcode14,5,70925183,A,DEL,1307,2,2,0,0.15
barcode14,5,70925188,A,DEL,1276,1,1,0,0.08
barcode14,5,70925192,C,DEL,1243,3,3,0,0.24
barcode14,5,70925193,G,DEL,1235,3,3,0,0.24
barcode14,5,70925194,C,DEL,1227,9,1,8,0.73
barcode14,5,70925195,A,DEL,1207,7,7,0,0.58
barcode14,5,70925196,G,DEL,1202,5,5,0,0.42
barcode14,5,70925197,C,DEL,1196,8,8,0,0.67
barcode14,5,70925198,C,DEL,1180,2,2,0,0.17
barcode14,5,70925199,A,DEL,1162,3,3,0,0.26
barcode14,5,70925200,G,DEL,1158,1,1,0,0.09
barcode14,5,70925201,T,DEL,1143,1,1,0,0.09
barcode14,5,70925202,G,DEL,1137,2,2,0,0.18
barcode14,5,70925203,C,DEL,1115,1,1,0,0.09
barcode14,5,70925206,T,DEL,1094,4,3,1,0.37
barcode14,5,70925207,C,DEL,1062,17,3,14,1.6
barcode14,5,70925208,T,DEL,1047,2,1,1,0.19
barcode14,5,70925209,C,DEL,1040,2,2,0,0.19
barcode14,5,70925213,A,DEL,418,6,6,0,1.44
barcode14,5,70938767,C,DEL,361,11,0,11,3.05
barcode14,5,70938768,T,DEL,398,26,4,22,6.53
barcode14,5,70938769,T,DEL,403,1,0,1,0.25
barcode14,5,70938770,G,DEL,408,3,0,3,0.74
barcode14,5,70938772,T,DEL,424,7,0,7,1.65
barcode14,5,70938774,C,DEL,438,1,0,1,0.23
barcode14,5,70938776,A,DEL,454,1,0,1,0.22
barcode14,5,70938779,A,DEL,470,1,0,1,0.21
barcode14,5,70938780,T,DEL,470,1,0,1,0.21
barcode14,5,70938781,A,DEL,472,3,3,0,0.64
barcode14,5,70938782,C,DEL,475,2,0,2,0.42
barcode14,5,70938783,A,DEL,476,4,0,4,0.84
barcode14,5,70938784,T,DEL,476,22,11,11,4.62
barcode14,5,70938785,T,DEL,478,4,0,4,0.84
barcode14,5,70938786,T,DEL,481,2,2,0,0.42
barcode14,5,70938787,T,DEL,487,8,7,1,1.64
barcode14,5,70938788,C,DEL,496,13,7,6,2.62
barcode14,5,70938789,T,DEL,496,2,0,2,0.4
barcode14,5,70938790,G,DEL,498,13,0,13,2.61
barcode14,5,70938792,T,DEL,504,3,3,0,0.6
barcode14,5,70938794,A,DEL,509,22,0,22,4.32
barcode14,5,70938801,T,DEL,563,1,0,1,0.18
barcode14,5,70938803,T,DEL,577,4,0,4,0.69
barcode14,5,70938804,G,DEL,578,19,0,19,3.29
barcode14,5,70938805,A,DEL,585,23,0,23,3.93
barcode14,5,70938807,C,DEL,636,1,0,1,0.16
barcode14,5,70938808,A,DEL,645,1,0,1,0.16
barcode14,5,70938809,T,DEL,651,1,0,1,0.15
barcode14,5,70938810,G,DEL,675,2,0,2,0.3
barcode14,5,70938812,G,DEL,691,1,1,0,0.14
barcode14,5,70938813,T,DEL,704,2,2,0,0.28
barcode14,5,70938814,T,DEL,704,1,1,0,0.14
barcode14,5,70938815,G,DEL,715,3,1,2,0.42
barcode14,5,70938816,T,DEL,718,60,35,25,8.36
barcode14,5,70938817,T,DEL,720,20,20,0,2.78
barcode14,5,70938818,T,DEL,723,3,3,0,0.41
barcode14,5,70938819,T,DEL,723,3,3,0,0.41
barcode14,5,70938820,T,DEL,724,5,5,0,0.69
barcode14,5,70938821,A,DEL,726,6,6,0,0.83
barcode14,5,70938822,T,DEL,726,4,3,1,0.55
barcode14,5,70938823,T,DEL,729,2,2,0,0.27
barcode14,5,70938824,T,DEL,728,3,3,0,0.41
barcode14,5,70938825,C,DEL,735,3,3,0,0.41
barcode14,5,70938826,T,DEL,739,10,10,0,1.35
barcode14,5,70938827,T,DEL,740,2,0,2,0.27
barcode14,5,70938828,A,DEL,745,4,1,3,0.54
barcode14,5,70938829,C,DEL,745,10,1,9,1.34
barcode14,5,70938830,C,DEL,746,1,0,1,0.13
barcode14,5,70938831,C,DEL,747,3,2,1,0.4
barcode14,5,70938832,T,DEL,747,17,17,0,2.28
barcode14,5,70938833,T,DEL,756,2,2,0,0.26
barcode14,5,70938835,C,DEL,771,4,3,1,0.52
barcode14,5,70938837,A,DEL,781,2,0,2,0.26
barcode14,5,70938838,G,DEL,789,2,0,2,0.25
barcode14,5,70938842,G,DEL,795,1,0,1,0.13
barcode14,5,70938843,A,DEL,797,1,0,1,0.13
barcode14,5,70938845,G,DEL,787,1,0,1,0.13
barcode14,5,70938847,T,DEL,774,4,4,0,0.52
barcode14,5,70938848,T,DEL,775,2,2,0,0.26
barcode14,5,70938849,C,DEL,783,4,2,2,0.51
barcode14,5,70938851,G,DEL,783,11,0,11,1.4
barcode14,5,70938852,A,DEL,784,2,0,2,0.26
barcode14,5,70938853,C,DEL,777,1,0,1,0.13
barcode14,5,70938855,T,DEL,773,9,4,5,1.16
barcode14,5,70938857,T,DEL,782,2,1,1,0.26
barcode14,5,70938858,G,DEL,784,29,5,24,3.7
barcode14,5,70938864,A,DEL,779,5,0,5,0.64
barcode14,5,70938865,T,DEL,775,4,0,4,0.52
barcode14,5,70938866,A,DEL,798,2,2,0,0.25
barcode14,5,70938867,C,DEL,796,1,1,0,0.13
barcode14,5,70938868,A,DEL,790,1,1,0,0.13
barcode14,5,70938869,G,DEL,787,4,1,3,0.51
barcode14,5,70938873,T,DEL,795,4,0,4,0.5
barcode14,5,70938874,G,DEL,788,1,0,1,0.13
barcode14,5,70938875,A,DEL,785,1,0,1,0.13
barcode14,5,70938877,A,DEL,768,32,28,4,4.17
barcode14,5,70938890,A,DEL,739,3,1,2,0.41
barcode14,5,70938895,T,DEL,726,1,1,0,0.14
barcode14,5,70938896,G,DEL,721,1,1,0,0.14
barcode14,5,70938900,C,DEL,675,1,0,1,0.15
barcode14,5,70938901,T,DEL,673,9,9,0,1.34
barcode14,5,70938905,T,DEL,659,7,1,6,1.06
barcode14,5,70938907,T,DEL,657,2,0,2,0.3
barcode14,5,70938908,A,DEL,655,10,1,9,1.53
barcode14,5,70938912,T,DEL,640,1,0,1,0.16
barcode14,5,70938913,A,DEL,629,1,0,1,0.16
barcode14,5,70938915,G,DEL,619,1,1,0,0.16
barcode14,5,70938916,A,DEL,611,3,1,2,0.49
barcode14,5,70938919,T,DEL,598,15,15,0,2.51
barcode14,5,70938920,G,DEL,598,15,15,0,2.51
barcode14,5,70938921,C,DEL,595,16,16,0,2.69
barcode14,5,70938922,T,DEL,594,16,16,0,2.69
barcode14,5,70938923,T,DEL,592,1,1,0,0.17
barcode14,5,70938924,G,DEL,585,5,5,0,0.85
barcode14,5,70938925,C,DEL,572,2,1,1,0.35
barcode14,5,70938926,T,DEL,570,3,3,0,0.53
barcode14,5,70938928,A,DEL,559,3,3,0,0.54
barcode14,5,70938929,G,DEL,557,3,3,0,0.54
barcode14,5,70938931,C,DEL,548,4,2,2,0.73
barcode14,5,70938932,G,DEL,547,3,2,1,0.55
barcode14,5,70938933,T,DEL,547,24,24,0,4.39
barcode14,5,70938935,T,DEL,536,1,1,0,0.19
barcode14,5,70938936,T,DEL,532,2,2,0,0.38
barcode14,5,70938937,C,DEL,529,2,2,0,0.38
barcode14,5,70938941,T,DEL,525,46,46,0,8.76
barcode14,5,70938944,T,DEL,507,6,6,0,1.18
barcode14,5,70938945,C,DEL,502,11,11,0,2.19
barcode14,5,70941357,T,DEL,56,1,0,1,1.79
barcode14,5,70941358,A,DEL,95,1,0,1,1.05
barcode14,5,70941365,A,DEL,155,1,1,0,0.65
barcode14,5,70941366,C,DEL,156,1,1,0,0.64
barcode14,5,70941367,A,DEL,158,1,0,1,0.63
barcode14,5,70941368,T,DEL,160,31,1,30,19.38
barcode14,5,70941376,C,DEL,177,1,0,1,0.56
barcode14,5,70941377,C,DEL,178,1,0,1,0.56
barcode14,5,70941378,T,DEL,178,5,0,5,2.81
barcode14,5,70941380,T,DEL,185,8,3,5,4.32
barcode14,5,70941383,T,DEL,196,1,0,1,0.51
barcode14,5,70941384,C,DEL,199,32,0,32,16.08
barcode14,5,70941385,G,DEL,206,1,0,1,0.49
barcode14,5,70941386,T,DEL,206,11,0,11,5.34
barcode14,5,70941388,G,DEL,211,1,0,1,0.47
barcode14,5,70941393,C,DEL,235,1,0,1,0.43
barcode14,5,70941394,T,DEL,243,1,0,1,0.41
barcode14,5,70941395,C,DEL,252,5,2,3,1.98
barcode14,5,70941396,T,DEL,256,6,0,6,2.34
barcode14,5,70941397,A,DEL,260,20,0,20,7.69
barcode14,5,70941400,G,DEL,265,1,0,1,0.38
barcode14,5,70941403,T,DEL,273,1,0,1,0.37
barcode14,5,70941404,G,DEL,274,1,0,1,0.36
barcode14,5,70941409,C,DEL,297,1,1,0,0.34
barcode14,5,70941411,T,DEL,302,4,4,0,1.32
barcode14,5,70941413,T,DEL,305,4,4,0,1.31
barcode14,5,70941414,G,DEL,309,6,6,0,1.94
barcode14,5,70941415,T,DEL,313,1,0,1,0.32
barcode14,5,70941416,G,DEL,313,2,0,2,0.64
barcode14,5,70941417,A,DEL,316,14,0,14,4.43
barcode14,5,70941419,A,DEL,319,1,1,0,0.31
barcode14,5,70941420,C,DEL,319,1,1,0,0.31
barcode14,5,70941421,T,DEL,330,20,20,0,6.06
barcode14,5,70941423,C,DEL,345,2,2,0,0.58
barcode14,5,70941424,G,DEL,358,15,0,15,4.19
barcode14,5,70941425,G,DEL,361,1,0,1,0.28
barcode14,5,70941426,G,DEL,359,2,0,2,0.56
barcode14,5,70941427,T,DEL,364,3,0,3,0.82
barcode14,5,70941428,A,DEL,363,3,1,2,0.83
barcode14,5,70941431,C,DEL,367,10,9,1,2.72
barcode14,5,70941433,A,DEL,369,32,4,28,8.67
barcode14,5,70941438,C,DEL,377,1,0,1,0.27
barcode14,5,70941446,A,DEL,385,27,4,23,7.01
barcode14,5,70941447,A,DEL,385,1,0,1,0.26
barcode14,5,70941448,A,DEL,385,1,0,1,0.26
barcode14,5,70941449,A,DEL,385,3,2,1,0.78
barcode14,5,70941450,G,DEL,383,3,2,1,0.78
barcode14,5,70941451,A,DEL,383,5,2,3,1.31
barcode14,5,70941454,A,DEL,384,1,1,0,0.26
barcode14,5,70941455,C,DEL,384,1,1,0,0.26
barcode14,5,70941456,C,DEL,386,1,1,0,0.26
barcode14,5,70941457,T,DEL,386,1,1,0,0.26
barcode14,5,70941458,G,DEL,388,3,3,0,0.77
barcode14,5,70941459,C,DEL,385,1,0,1,0.26
barcode14,5,70941460,T,DEL,386,1,0,1,0.26
barcode14,5,70941461,A,DEL,391,23,18,5,5.88
barcode14,5,70941462,A,DEL,395,15,12,3,3.8
barcode14,5,70941463,G,DEL,393,15,13,2,3.82
barcode14,5,70941464,A,DEL,396,11,10,1,2.78
barcode14,5,70941465,A,DEL,395,20,19,1,5.06
barcode14,5,70941466,G,DEL,393,25,24,1,6.36
barcode14,5,70941467,A,DEL,391,4,2,2,1.02
barcode14,5,70941468,A,DEL,391,1,0,1,0.26
barcode14,5,70941469,T,DEL,391,2,0,2,0.51
barcode14,5,70941470,A,DEL,388,13,2,11,3.35
barcode14,5,70941471,A,DEL,389,1,0,1,0.26
barcode14,5,70941472,A,DEL,388,1,1,0,0.26
barcode14,5,70941473,A,DEL,388,2,2,0,0.52
barcode14,5,70941474,G,DEL,387,2,2,0,0.52
barcode14,5,70941475,C,DEL,385,3,3,0,0.78
barcode14,5,70941476,C,DEL,385,2,2,0,0.52
barcode14,5,70941477,A,DEL,385,45,12,33,11.69
barcode14,5,70941478,A,DEL,384,8,2,6,2.08
barcode14,5,70941479,A,DEL,382,4,3,1,1.05
barcode14,5,70941480,A,DEL,380,5,3,2,1.32
barcode14,5,70941481,G,DEL,380,5,3,2,1.32
barcode14,5,70941482,A,DEL,379,5,0,5,1.32
barcode14,5,70941483,A,DEL,379,8,6,2,2.11
barcode14,5,70941484,G,DEL,379,10,8,2,2.64
barcode14,5,70941485,A,DEL,376,18,18,0,4.79
barcode14,5,70941491,G,DEL,372,1,1,0,0.27
barcode14,5,70941492,C,DEL,372,1,0,1,0.27
barcode14,5,70941495,C,DEL,356,5,0,5,1.4
barcode14,5,70941496,T,DEL,356,18,17,1,5.06
barcode14,5,70941500,T,DEL,339,29,29,0,8.55
barcode14,5,70941502,A,DEL,334,7,7,0,2.1
barcode14,5,70941503,C,DEL,333,1,1,0,0.3
barcode14,5,70941511,T,DEL,306,1,1,0,0.33
barcode14,5,70941512,A,DEL,302,1,1,0,0.33
barcode14,5,70941513,T,DEL,302,14,14,0,4.64
barcode14,5,70941517,A,DEL,294,4,2,2,1.36
barcode14,5,70941523,T,DEL,286,18,18,0,6.29
barcode14,5,70941524,T,DEL,282,1,1,0,0.35
barcode14,5,70941525,G,DEL,276,2,2,0,0.72
barcode14,5,70941527,G,DEL,264,1,1,0,0.38
barcode14,5,70941529,T,DEL,255,7,7,0,2.75
barcode14,5,70941530,T,DEL,254,1,1,0,0.39
barcode14,5,70941531,T,DEL,251,1,0,1,0.4
barcode14,5,70941532,A,DEL,251,1,0,1,0.4
barcode14,5,70941535,T,DEL,250,16,16,0,6.4
barcode14,5,70941538,A,DEL,238,1,0,1,0.42
barcode14,5,70942313,T,DEL,18,1,1,0,5.56
barcode14,5,70942314,C,DEL,39,1,1,0,2.56
barcode14,5,70942315,A,DEL,57,1,1,0,1.75
barcode14,5,70942333,T,DEL,116,9,0,9,7.76
barcode14,5,70942334,A,DEL,118,4,0,4,3.39
barcode14,5,70942338,A,DEL,126,1,0,1,0.79
barcode14,5,70942339,T,DEL,126,2,0,2,1.59
barcode14,5,70942340,C,DEL,126,1,0,1,0.79
barcode14,5,70942341,T,DEL,126,9,8,1,7.14
barcode14,5,70942344,G,DEL,230,8,0,8,3.48
barcode14,5,70942350,T,DEL,239,16,12,4,6.69
barcode14,5,70942354,G,DEL,330,1,0,1,0.3
barcode14,5,70942359,G,DEL,386,1,1,0,0.26
barcode14,5,70942361,A,DEL,386,31,6,25,8.03
barcode14,5,70942364,G,DEL,387,1,0,1,0.26
barcode14,5,70942365,T,DEL,388,1,0,1,0.26
barcode14,5,70942367,G,DEL,395,29,12,17,7.34
barcode14,5,70942370,G,DEL,398,1,1,0,0.25
barcode14,5,70942371,A,DEL,398,1,1,0,0.25
barcode14,5,70942372,C,DEL,398,3,1,2,0.75
barcode14,5,70942373,A,DEL,400,10,1,9,2.5
barcode14,5,70942376,T,DEL,403,1,1,0,0.25
barcode14,5,70942377,G,DEL,403,1,1,0,0.25
barcode14,5,70942378,T,DEL,407,2,1,1,0.49
barcode14,5,70942379,T,DEL,407,1,1,0,0.25
barcode14,5,70942380,C,DEL,412,3,3,0,0.73
barcode14,5,70942382,G,DEL,415,2,2,0,0.48
barcode14,5,70942383,C,DEL,415,1,1,0,0.24
barcode14,5,70942386,T,DEL,416,15,13,2,3.61
barcode14,5,70942387,T,DEL,416,3,3,0,0.72
barcode14,5,70942388,T,DEL,416,5,5,0,1.2
barcode14,5,70942389,G,DEL,416,5,5,0,1.2
barcode14,5,70942390,G,DEL,416,5,5,0,1.2
barcode14,5,70942392,C,DEL,416,6,6,0,1.44
barcode14,5,70942393,A,DEL,415,13,1,12,3.13
barcode14,5,70942394,G,DEL,415,13,0,13,3.13
barcode14,5,70942395,A,DEL,415,1,1,0,0.24
barcode14,5,70942398,A,DEL,415,10,10,0,2.41
barcode14,5,70942399,C,DEL,415,1,1,0,0.24
barcode14,5,70942400,G,DEL,415,1,1,0,0.24
barcode14,5,70942401,G,DEL,416,2,2,0,0.48
barcode14,5,70942402,T,DEL,416,47,47,0,11.3
barcode14,5,70942403,T,DEL,416,1,1,0,0.24
barcode14,5,70942404,G,DEL,416,1,0,1,0.24
barcode14,5,70942405,C,DEL,415,2,0,2,0.48
barcode14,5,70942406,A,DEL,414,1,1,0,0.24
barcode14,5,70942407,T,DEL,414,32,26,6,7.73
barcode14,5,70942408,T,DEL,423,1,1,0,0.24
barcode14,5,70942409,T,DEL,425,1,1,0,0.24
barcode14,5,70942410,A,DEL,430,1,1,0,0.23
barcode14,5,70942411,C,DEL,431,17,16,1,3.94
barcode14,5,70942412,C,DEL,435,1,1,0,0.23
barcode14,5,70942419,C,DEL,428,2,2,0,0.47
barcode14,5,70942420,C,DEL,430,1,1,0,0.23
barcode14,5,70942422,T,DEL,433,2,2,0,0.46
barcode14,5,70942423,T,DEL,433,2,2,0,0.46
barcode14,5,70942424,G,DEL,446,2,2,0,0.45
barcode14,5,70942425,C,DEL,448,2,2,0,0.45
barcode14,5,70942426,T,DEL,450,15,15,0,3.33
barcode14,5,70942429,A,DEL,466,5,5,0,1.07
barcode14,5,70942431,T,DEL,467,1,1,0,0.21
barcode14,5,70942432,T,DEL,467,1,1,0,0.21
barcode14,5,70942433,G,DEL,467,2,1,1,0.43
barcode14,5,70942434,A,DEL,467,1,1,0,0.21
barcode14,5,70942435,T,DEL,467,23,22,1,4.93
barcode14,5,70942436,T,DEL,468,5,5,0,1.07
barcode14,5,70942437,T,DEL,467,11,11,0,2.36
barcode14,5,70942438,T,DEL,463,43,42,1,9.29
barcode14,5,70942439,A,DEL,462,78,72,6,16.88
barcode14,5,70942440,A,DEL,461,49,45,4,10.63
barcode14,5,70942441,G,DEL,461,35,31,4,7.59
barcode14,5,70942442,A,DEL,471,26,26,0,5.52
barcode14,5,70942443,G,DEL,471,6,6,0,1.27
barcode14,5,70942444,A,DEL,472,6,6,0,1.27
barcode14,5,70942445,G,DEL,472,5,5,0,1.06
barcode14,5,70942446,A,DEL,472,5,4,1,1.06
barcode14,5,70942454,G,DEL,480,1,1,0,0.21
barcode14,5,70942457,G,DEL,493,1,0,1,0.2
barcode14,5,70942459,G,DEL,494,2,2,0,0.4
barcode14,5,70942464,A,DEL,492,2,2,0,0.41
barcode14,5,70942468,T,DEL,509,1,1,0,0.2
barcode14,5,70942469,G,DEL,510,1,1,0,0.2
barcode14,5,70942472,T,DEL,509,1,1,0,0.2
barcode14,5,70942477,A,DEL,501,2,0,2,0.4
barcode14,5,70942481,A,DEL,497,10,7,3,2.01
barcode14,5,70942482,G,DEL,497,4,1,3,0.8
barcode14,5,70942483,A,DEL,495,3,3,0,0.61
barcode14,5,70942484,G,DEL,495,11,11,0,2.22
barcode14,5,70942485,A,DEL,492,12,12,0,2.44
barcode14,5,70942486,G,DEL,487,31,31,0,6.37
barcode14,5,70942487,G,DEL,487,2,2,0,0.41
barcode14,5,70942488,A,DEL,485,2,2,0,0.41
barcode14,5,70942489,G,DEL,485,1,1,0,0.21
barcode14,5,70942490,C,DEL,484,2,2,0,0.41
barcode14,5,70942491,A,DEL,484,9,8,1,1.86
barcode14,5,70942492,A,DEL,485,1,1,0,0.21
barcode14,5,70942493,A,DEL,485,1,1,0,0.21
barcode14,5,70942494,A,DEL,483,4,1,3,0.83
barcode14,5,70942495,T,DEL,481,5,2,3,1.04
barcode14,5,70942496,C,DEL,477,5,3,2,1.05
barcode14,5,70942497,T,DEL,477,1,1,0,0.21
barcode14,5,70942498,G,DEL,475,1,1,0,0.21
barcode14,5,70942499,T,DEL,475,7,7,0,1.47
barcode14,5,70942500,C,DEL,474,6,6,0,1.27
barcode14,5,70942501,C,DEL,474,1,1,0,0.21
barcode14,5,70942502,G,DEL,470,1,1,0,0.21
barcode14,5,70942506,T,DEL,467,1,0,1,0.21
barcode14,5,70942507,A,DEL,467,1,1,0,0.21
barcode14,5,70942508,C,DEL,468,1,1,0,0.21
barcode14,5,70942509,T,DEL,468,18,17,1,3.85
barcode14,5,70942510,T,DEL,472,1,0,1,0.21
barcode14,5,70942511,T,DEL,471,60,55,5,12.74
barcode14,5,70942512,C,DEL,471,189,181,8,40.13
barcode14,5,70942513,C,DEL,499,15,15,0,3.01
barcode14,5,70942516,A,DEL,500,1,1,0,0.2
barcode14,5,70942517,A,DEL,501,1,1,0,0.2
barcode14,5,70942518,T,DEL,501,1,1,0,0.2
barcode14,5,70942519,C,DEL,509,1,1,0,0.2
barcode14,5,70942522,T,DEL,508,2,2,0,0.39
barcode14,5,70942524,A,DEL,505,1,0,1,0.2
barcode14,5,70942532,A,DEL,497,1,0,1,0.2
barcode14,5,70942535,A,DEL,492,1,0,1,0.2
barcode14,5,70942536,A,DEL,491,2,2,0,0.41
barcode14,5,70942537,T,DEL,490,2,2,0,0.41
barcode14,5,70942539,T,DEL,483,1,0,1,0.21
barcode14,5,70942541,G,DEL,474,7,6,1,1.48
barcode14,5,70942544,C,DEL,469,1,1,0,0.21
barcode14,5,70942545,A,DEL,466,2,1,1,0.43
barcode14,5,70942549,T,DEL,461,1,1,0,0.22
barcode14,5,70942554,A,DEL,453,1,1,0,0.22
barcode14,5,70942556,G,DEL,448,1,0,1,0.22
barcode14,5,70942557,A,DEL,444,12,12,0,2.7
barcode14,5,70942559,G,DEL,441,1,1,0,0.23
barcode14,5,70942560,T,DEL,438,1,1,0,0.23
barcode14,5,70942561,A,DEL,431,1,0,1,0.23
barcode14,5,70942563,G,DEL,431,2,2,0,0.46
barcode14,5,70942565,A,DEL,421,1,1,0,0.24
barcode14,5,70942567,A,DEL,411,1,1,0,0.24
barcode14,5,70942568,C,DEL,408,1,1,0,0.25
barcode14,5,70942569,A,DEL,396,53,53,0,13.38
barcode14,5,70942570,A,DEL,394,41,41,0,10.41
barcode14,5,70942571,A,DEL,392,21,21,0,5.36
barcode14,5,70942572,A,DEL,389,6,6,0,1.54
barcode14,5,70942678,A,DEL,221,2,0,2,0.9
barcode14,5,70942689,A,DEL,298,17,3,14,5.7
barcode14,5,70942700,T,DEL,306,4,0,4,1.31
barcode14,5,70942701,A,DEL,306,4,0,4,1.31
barcode14,5,70942702,T,DEL,306,5,0,5,1.63
barcode14,5,70942703,T,DEL,306,1,0,1,0.33
barcode14,5,70942705,T,DEL,308,1,0,1,0.32
barcode14,5,70942706,T,DEL,308,5,0,5,1.62
barcode14,5,70942707,T,DEL,309,13,0,13,4.21
barcode14,5,70942708,C,DEL,310,18,0,18,5.81
barcode14,5,70942709,T,DEL,310,45,0,45,14.52
barcode14,5,70942710,T,DEL,312,6,0,6,1.92
barcode14,5,70942713,T,DEL,314,3,0,3,0.96
barcode14,5,70942714,A,DEL,316,20,0,20,6.33
barcode14,5,70942717,G,DEL,317,1,0,1,0.32
barcode14,5,70942718,A,DEL,320,3,0,3,0.94
barcode14,5,70942721,G,DEL,320,4,0,4,1.25
barcode14,5,70942722,A,DEL,320,27,0,27,8.44
barcode14,5,70942723,A,DEL,322,3,0,3,0.93
barcode14,5,70942727,G,DEL,324,20,0,20,6.17
barcode14,5,70942734,A,DEL,327,5,0,5,1.53
barcode14,5,70942737,T,DEL,326,4,1,3,1.23
barcode14,5,70942741,A,DEL,337,1,0,1,0.3
barcode14,5,70942746,A,DEL,337,2,0,2,0.59
barcode14,5,70942748,G,DEL,335,3,0,3,0.9
barcode14,5,70942749,A,DEL,337,26,0,26,7.72
barcode14,5,70942755,A,DEL,331,3,0,3,0.91
barcode14,5,70942756,G,DEL,329,3,0,3,0.91
barcode14,5,70942757,A,DEL,328,16,0,16,4.88
barcode14,5,70942759,C,DEL,332,1,0,1,0.3
barcode14,5,70942761,C,DEL,345,4,0,4,1.16
barcode14,5,70942764,G,DEL,341,1,0,1,0.29
barcode14,5,70942765,G,DEL,338,1,0,1,0.3
barcode14,5,70942766,T,DEL,339,14,0,14,4.13
barcode14,5,70942767,C,DEL,339,16,0,16,4.72
barcode14,5,70942768,T,DEL,342,3,0,3,0.88
barcode14,5,70942769,C,DEL,348,6,0,6,1.72
barcode14,5,70942770,C,DEL,357,1,0,1,0.28
barcode14,5,70942771,T,DEL,360,2,0,2,0.56
barcode14,5,70942772,G,DEL,361,7,0,7,1.94
barcode14,5,70942774,A,DEL,362,10,0,10,2.76
barcode14,5,70942775,A,DEL,359,1,0,1,0.28
barcode14,5,70942776,A,DEL,359,1,0,1,0.28
barcode14,5,70942777,T,DEL,358,2,0,2,0.56
barcode14,5,70942783,A,DEL,364,1,0,1,0.27
barcode14,5,70942784,G,DEL,361,2,0,2,0.55
barcode14,5,70942785,A,DEL,296,1,0,1,0.34
barcode14,5,70942786,T,DEL,297,2,0,2,0.67
barcode14,5,70942789,C,DEL,284,1,0,1,0.35
barcode14,5,70942791,T,DEL,284,1,0,1,0.35
barcode14,5,70942792,C,DEL,285,1,0,1,0.35
barcode14,5,70942793,A,DEL,285,1,0,1,0.35
barcode14,5,70942796,C,DEL,286,6,6,0,2.1
barcode14,5,70942799,A,DEL,261,1,1,0,0.38
barcode14,5,70942801,A,DEL,262,3,0,3,1.15
barcode14,5,70942802,T,DEL,262,11,0,11,4.2
barcode14,5,70942803,C,DEL,265,12,0,12,4.53
barcode14,5,70942804,T,DEL,272,1,0,1,0.37
barcode14,5,70942806,C,DEL,295,1,0,1,0.34
barcode14,5,70942807,T,DEL,298,1,0,1,0.34
barcode14,5,70942808,C,DEL,300,1,0,1,0.33
barcode14,5,70942812,G,DEL,308,1,0,1,0.32
barcode14,5,70942815,A,DEL,307,1,1,0,0.33
barcode14,5,70942816,C,DEL,303,1,1,0,0.33
barcode14,5,70942817,T,DEL,304,1,0,1,0.33
barcode14,5,70942818,C,DEL,304,2,1,1,0.66
barcode14,5,70942819,T,DEL,305,22,2,20,7.21
barcode14,5,70942820,T,DEL,305,6,0,6,1.97
barcode14,5,70942821,T,DEL,302,9,1,8,2.98
barcode14,5,70942822,T,DEL,297,22,1,21,7.41
barcode14,5,70942823,C,DEL,295,32,1,31,10.85
barcode14,5,70942824,T,DEL,295,26,0,26,8.81
barcode14,5,70942825,C,DEL,295,59,13,46,20.0
barcode14,5,70942826,C,DEL,297,21,0,21,7.07
barcode14,5,70942827,C,DEL,287,9,0,9,3.14
barcode14,5,70942828,T,DEL,289,11,0,11,3.81
barcode14,5,70942829,C,DEL,289,15,1,14,5.19
barcode14,5,70942830,C,DEL,289,5,0,5,1.73
barcode14,5,70942832,C,DEL,290,1,1,0,0.34
barcode14,5,70942833,C,DEL,290,1,0,1,0.34
barcode14,5,70942834,A,DEL,290,3,0,3,1.03
barcode14,5,70942835,C,DEL,290,88,64,24,30.34
barcode14,5,70942836,C,DEL,281,6,5,1,2.14
barcode14,5,70942837,C,DEL,281,3,2,1,1.07
barcode14,5,70942838,C,DEL,281,2,1,1,0.71
barcode14,5,70942839,C,DEL,277,1,0,1,0.36
barcode14,5,70942840,C,DEL,276,1,0,1,0.36
barcode14,5,70942841,A,DEL,276,1,0,1,0.36
barcode14,5,70942842,T,DEL,276,1,0,1,0.36
barcode14,5,70942844,C,DEL,276,5,4,1,1.81
barcode14,5,70942845,C,DEL,276,1,0,1,0.36
barcode14,5,70942847,G,DEL,276,5,4,1,1.81
barcode14,5,70942852,A,DEL,270,12,4,8,4.44
barcode14,5,70942857,T,DEL,270,14,0,14,5.19
barcode14,5,70942858,G,DEL,271,10,1,9,3.69
barcode14,5,70942860,G,DEL,271,1,0,1,0.37
barcode14,5,70942861,A,DEL,273,1,0,1,0.37
barcode14,5,70942862,C,DEL,273,2,1,1,0.73
barcode14,5,70942863,C,DEL,273,1,0,1,0.37
barcode14,5,70942864,A,DEL,272,1,1,0,0.37
barcode14,5,70942865,G,DEL,271,2,1,1,0.74
barcode14,5,70942866,G,DEL,267,2,2,0,0.75
barcode14,5,70942867,A,DEL,266,12,2,10,4.51
barcode14,5,70942868,A,DEL,266,3,1,2,1.13
barcode14,5,70942869,A,DEL,265,1,0,1,0.38
barcode14,5,70942870,G,DEL,264,1,0,1,0.38
barcode14,5,70942872,T,DEL,263,3,1,2,1.14
barcode14,5,70942873,A,DEL,263,6,1,5,2.28
barcode14,5,70942874,A,DEL,263,4,1,3,1.52
barcode14,5,70942875,A,DEL,264,2,1,1,0.76
barcode14,5,70942876,C,DEL,264,2,1,1,0.76
barcode14,5,70942877,C,DEL,264,2,1,1,0.76
barcode14,5,70942878,T,DEL,263,2,2,0,0.76
barcode14,5,70942879,T,DEL,263,1,1,0,0.38
barcode14,5,70942880,C,DEL,262,1,1,0,0.38
barcode14,5,70942881,T,DEL,262,9,0,9,3.44
barcode14,5,70942882,A,DEL,262,1,0,1,0.38
barcode14,5,70942884,G,DEL,261,1,0,1,0.38
barcode14,5,70942885,A,DEL,261,10,1,9,3.83
barcode14,5,70942889,T,DEL,255,4,3,1,1.57
barcode14,5,70942890,T,DEL,254,1,0,1,0.39
barcode14,5,70942893,C,DEL,253,2,1,1,0.79
barcode14,5,70942895,A,DEL,251,18,15,3,7.17
barcode14,5,70942896,G,DEL,250,17,14,3,6.8
barcode14,5,70942897,A,DEL,245,10,2,8,4.08
barcode14,5,70942898,A,DEL,245,1,1,0,0.41
barcode14,5,70942904,T,DEL,244,3,3,0,1.23
barcode14,5,70942906,A,DEL,243,26,0,26,10.7
barcode14,5,70942908,T,DEL,240,1,1,0,0.42
barcode14,5,70942909,G,DEL,240,3,1,2,1.25
barcode14,5,70942911,C,DEL,239,9,7,2,3.77
barcode14,5,70942912,G,DEL,239,5,1,4,2.09
barcode14,5,70942915,A,DEL,225,1,0,1,0.44
barcode14,5,70942918,T,DEL,222,9,6,3,4.05
barcode14,5,70942920,T,DEL,217,2,0,2,0.92
barcode14,5,70942921,A,DEL,215,2,0,2,0.93
barcode14,5,70942929,T,DEL,204,3,0,3,1.47
barcode14,5,70942930,G,DEL,204,2,2,0,0.98
barcode14,5,70942931,T,DEL,203,5,5,0,2.46
barcode14,5,70942939,T,DEL,167,12,11,1,7.19
barcode14,5,70942948,C,DEL,103,1,0,1,0.97
barcode14,5,70944618,A,DEL,558,1,0,1,0.18
barcode14,5,70944621,T,DEL,605,1,0,1,0.17
barcode14,5,70944623,G,DEL,629,2,0,2,0.32
barcode14,5,70944624,G,DEL,636,2,0,2,0.31
barcode14,5,70944625,T,DEL,640,7,0,7,1.09
barcode14,5,70944626,A,DEL,652,30,0,30,4.6
barcode14,5,70944628,G,DEL,665,1,0,1,0.15
barcode14,5,70944629,T,DEL,669,1,0,1,0.15
barcode14,5,70944631,A,DEL,677,1,0,1,0.15
barcode14,5,70944633,T,DEL,684,27,0,27,3.95
barcode14,5,70944637,C,DEL,700,1,0,1,0.14
barcode14,5,70944639,T,DEL,701,17,13,4,2.43
barcode14,5,70944640,T,DEL,704,1,0,1,0.14
barcode14,5,70944641,T,DEL,706,2,0,2,0.28
barcode14,5,70944642,G,DEL,709,12,0,12,1.69
barcode14,5,70944643,A,DEL,711,5,0,5,0.7
barcode14,5,70944647,A,DEL,722,2,0,2,0.28
barcode14,5,70944648,T,DEL,723,4,2,2,0.55
barcode14,5,70944649,T,DEL,728,16,0,16,2.2
barcode14,5,70944650,C,DEL,734,17,0,17,2.32
barcode14,5,70944652,T,DEL,738,9,0,9,1.22
barcode14,5,70944653,T,DEL,741,8,0,8,1.08
barcode14,5,70944660,A,DEL,778,2,1,1,0.26
barcode14,5,70944661,G,DEL,782,2,1,1,0.26
barcode14,5,70944663,T,DEL,783,4,0,4,0.51
barcode14,5,70944664,C,DEL,783,3,0,3,0.38
barcode14,5,70944665,T,DEL,783,11,0,11,1.4
barcode14,5,70944666,A,DEL,787,15,2,13,1.91
barcode14,5,70944667,A,DEL,789,2,0,2,0.25
barcode14,5,70944668,A,DEL,790,2,0,2,0.25
barcode14,5,70944669,A,DEL,791,3,0,3,0.38
barcode14,5,70944670,T,DEL,793,5,1,4,0.63
barcode14,5,70944672,C,DEL,803,2,0,2,0.25
barcode14,5,70944673,A,DEL,805,6,0,6,0.75
barcode14,5,70944676,G,DEL,815,2,1,1,0.25
barcode14,5,70944678,C,DEL,819,25,0,25,3.05
barcode14,5,70944679,C,DEL,822,3,2,1,0.36
barcode14,5,70944680,C,DEL,828,4,3,1,0.48
barcode14,5,70944681,A,DEL,828,7,6,1,0.85
barcode14,5,70944682,C,DEL,829,3,1,2,0.36
barcode14,5,70944683,C,DEL,828,3,1,2,0.36
barcode14,5,70944684,A,DEL,835,3,1,2,0.36
barcode14,5,70944685,C,DEL,835,5,1,4,0.6
barcode14,5,70944686,C,DEL,835,5,1,4,0.6
barcode14,5,70944687,G,DEL,840,5,1,4,0.6
barcode14,5,70944688,C,DEL,846,2,1,1,0.24
barcode14,5,70944689,C,DEL,844,2,1,1,0.24
barcode14,5,70944690,A,DEL,846,2,1,1,0.24
barcode14,5,70944691,C,DEL,849,3,1,2,0.35
barcode14,5,70944692,C,DEL,846,3,1,2,0.35
barcode14,5,70944693,G,DEL,852,3,1,2,0.35
barcode14,5,70944694,C,DEL,852,11,0,11,1.29
barcode14,5,70944695,C,DEL,851,11,0,11,1.29
barcode14,5,70944696,A,DEL,853,12,0,12,1.41
barcode14,5,70944700,C,DEL,860,1,0,1,0.12
barcode14,5,70944703,C,DEL,881,1,0,1,0.11
barcode14,5,70944704,C,DEL,875,4,1,3,0.46
barcode14,5,70944705,A,DEL,876,4,1,3,0.46
barcode14,5,70944706,C,DEL,878,60,50,10,6.83
barcode14,5,70944707,C,DEL,880,10,0,10,1.14
barcode14,5,70944712,T,DEL,885,2,0,2,0.23
barcode14,5,70944714,A,DEL,883,12,12,0,1.36
barcode14,5,70944716,T,DEL,882,2,0,2,0.23
barcode14,5,70944718,T,DEL,879,1,0,1,0.11
barcode14,5,70944723,C,DEL,876,7,0,7,0.8
barcode14,5,70944724,T,DEL,876,17,0,17,1.94
barcode14,5,70944725,G,DEL,877,1,0,1,0.11
barcode14,5,70944727,C,DEL,871,2,0,2,0.23
barcode14,5,70944728,T,DEL,871,1,0,1,0.11
barcode14,5,70944729,G,DEL,870,1,0,1,0.11
barcode14,5,70944730,C,DEL,870,9,0,9,1.03
barcode14,5,70944733,C,DEL,869,1,0,1,0.12
barcode14,5,70944736,T,DEL,871,10,3,7,1.15
barcode14,5,70944737,T,DEL,871,1,0,1,0.11
barcode14,5,70944738,T,DEL,872,1,0,1,0.11
barcode14,5,70944739,C,DEL,874,2,0,2,0.23
barcode14,5,70944740,C,DEL,874,3,1,2,0.34
barcode14,5,70944741,T,DEL,874,23,4,19,2.63
barcode14,5,70944742,T,DEL,876,5,1,4,0.57
barcode14,5,70944743,C,DEL,879,6,1,5,0.68
barcode14,5,70944744,T,DEL,881,6,0,6,0.68
barcode14,5,70944748,C,DEL,866,1,1,0,0.12
barcode14,5,70944751,C,DEL,875,3,3,0,0.34
barcode14,5,70944753,A,DEL,871,5,0,5,0.57
barcode14,5,70944754,G,DEL,869,6,1,5,0.69
barcode14,5,70944755,T,DEL,870,14,0,14,1.61
barcode14,5,70944756,A,DEL,856,15,0,15,1.75
barcode14,5,70944757,A,DEL,856,11,0,11,1.29
barcode14,5,70944758,G,DEL,853,12,0,12,1.41
barcode14,5,70944759,T,DEL,853,49,0,49,5.74
barcode14,5,70944760,A,DEL,847,289,4,285,34.12
barcode14,5,70944761,A,DEL,846,167,0,167,19.74
barcode14,5,70944762,A,DEL,846,152,0,152,17.97
barcode14,5,70944763,A,DEL,846,47,0,47,5.56
barcode14,5,70944764,A,DEL,845,1,0,1,0.12
barcode14,5,70944765,A,DEL,844,3,1,2,0.36
barcode14,5,70944766,G,DEL,843,4,1,3,0.47
barcode14,5,70944767,A,DEL,842,6,3,3,0.71
barcode14,5,70944768,G,DEL,840,2,0,2,0.24
barcode14,5,70944769,T,DEL,839,64,0,64,7.63
barcode14,5,70944770,A,DEL,840,5,0,5,0.6
barcode14,5,70944771,T,DEL,840,5,0,5,0.6
barcode14,5,70944775,T,DEL,839,1,1,0,0.12
barcode14,5,70944776,T,DEL,837,2,0,2,0.24
barcode14,5,70944777,A,DEL,833,11,1,10,1.32
barcode14,5,70944778,G,DEL,832,15,4,11,1.8
barcode14,5,70944779,A,DEL,831,2,0,2,0.24
barcode14,5,70944780,T,DEL,831,40,7,33,4.81
barcode14,5,70944784,G,DEL,824,1,1,0,0.12
barcode14,5,70944785,C,DEL,822,1,0,1,0.12
barcode14,5,70944786,T,DEL,822,6,2,4,0.73
barcode14,5,70944789,C,DEL,811,3,1,2,0.37
barcode14,5,70944790,A,DEL,810,3,1,2,0.37
barcode14,5,70944791,C,DEL,807,1,0,1,0.12
barcode14,5,70944793,T,DEL,792,1,0,1,0.13
barcode14,5,70944794,A,DEL,782,3,2,1,0.38
barcode14,5,70944795,C,DEL,777,1,0,1,0.13
barcode14,5,70944798,T,DEL,770,9,2,7,1.17
barcode14,5,70944800,T,DEL,755,2,0,2,0.26
barcode14,5,70944801,G,DEL,748,2,0,2,0.27
barcode14,5,70944802,A,DEL,734,7,0,7,0.95
barcode14,5,70944803,T,DEL,726,5,0,5,0.69
barcode14,5,70944809,G,DEL,702,2,1,1,0.28
barcode14,5,70944813,A,DEL,653,2,1,1,0.31
barcode14,5,70944814,A,DEL,645,1,0,1,0.16
barcode14,5,70944815,T,DEL,639,1,0,1,0.16
barcode14,5,70944816,A,DEL,339,4,3,1,1.18
barcode14,5,70944817,G,DEL,330,4,2,2,1.21
barcode14,5,70944819,G,DEL,315,8,8,0,2.54
barcode14,5,70944820,G,DEL,305,7,7,0,2.3
barcode14,5,70944821,A,DEL,302,7,7,0,2.32
barcode14,5,70944822,T,DEL,300,1,1,0,0.33
barcode14,5,70944824,G,DEL,299,1,1,0,0.33
barcode14,5,70944825,T,DEL,292,2,0,2,0.68
barcode14,5,70944826,A,DEL,284,13,13,0,4.58
barcode14,5,70945981,T,DEL,304,1,0,1,0.33
barcode14,5,70945984,C,DEL,394,5,0,5,1.27
barcode14,5,70945987,G,DEL,422,2,0,2,0.47
barcode14,5,70945990,T,DEL,433,6,6,0,1.39
barcode14,5,70945995,T,DEL,464,6,4,2,1.29
barcode14,5,70945996,A,DEL,465,6,4,2,1.29
barcode14,5,70946000,A,DEL,482,4,1,3,0.83
barcode14,5,70946001,A,DEL,482,1,0,1,0.21
barcode14,5,70946002,T,DEL,483,7,0,7,1.45
barcode14,5,70946003,A,DEL,487,3,1,2,0.62
barcode14,5,70946004,T,DEL,488,3,0,3,0.61
barcode14,5,70946005,A,DEL,489,6,2,4,1.23
barcode14,5,70946006,A,DEL,490,3,0,3,0.61
barcode14,5,70946007,A,DEL,492,1,0,1,0.2
barcode14,5,70946008,T,DEL,492,1,0,1,0.2
barcode14,5,70946011,C,DEL,510,1,1,0,0.2
barcode14,5,70946012,C,DEL,511,3,0,3,0.59
barcode14,5,70946013,A,DEL,512,12,1,11,2.34
barcode14,5,70946014,G,DEL,512,13,2,11,2.54
barcode14,5,70946015,A,DEL,514,1,0,1,0.19
barcode14,5,70946017,T,DEL,518,9,9,0,1.74
barcode14,5,70946020,A,DEL,527,2,2,0,0.38
barcode14,5,70946021,C,DEL,527,1,1,0,0.19
barcode14,5,70946022,T,DEL,529,36,5,31,6.81
barcode14,5,70946027,T,DEL,543,3,3,0,0.55
barcode14,5,70946028,G,DEL,559,3,3,0,0.54
barcode14,5,70946029,T,DEL,563,8,6,2,1.42
barcode14,5,70946032,A,DEL,606,2,2,0,0.33
barcode14,5,70946033,C,DEL,609,10,0,10,1.64
barcode14,5,70946035,G,DEL,612,2,0,2,0.33
barcode14,5,70946036,G,DEL,614,2,0,2,0.33
barcode14,5,70946037,A,DEL,614,4,0,4,0.65
barcode14,5,70946038,T,DEL,614,4,0,4,0.65
barcode14,5,70946040,T,DEL,615,1,1,0,0.16
barcode14,5,70946041,A,DEL,622,37,1,36,5.95
barcode14,5,70946042,A,DEL,623,1,1,0,0.16
barcode14,5,70946043,A,DEL,623,1,1,0,0.16
barcode14,5,70946045,A,DEL,626,6,0,6,0.96
barcode14,5,70946046,A,DEL,626,2,1,1,0.32
barcode14,5,70946047,T,DEL,626,2,1,1,0.32
barcode14,5,70946050,C,DEL,636,5,0,5,0.79
barcode14,5,70946051,T,DEL,636,98,78,20,15.41
barcode14,5,70946052,T,DEL,640,26,24,2,4.06
barcode14,5,70946053,T,DEL,643,8,7,1,1.24
barcode14,5,70946054,T,DEL,645,3,2,1,0.47
barcode14,5,70946055,T,DEL,646,11,7,4,1.7
barcode14,5,70946056,C,DEL,650,12,7,5,1.85
barcode14,5,70946057,T,DEL,650,9,5,4,1.38
barcode14,5,70946058,G,DEL,649,5,5,0,0.77
barcode14,5,70946059,T,DEL,650,2,2,0,0.31
barcode14,5,70946060,C,DEL,650,23,2,21,3.54
barcode14,5,70946062,C,DEL,657,9,9,0,1.37
barcode14,5,70946063,C,DEL,667,1,0,1,0.15
barcode14,5,70946064,A,DEL,667,2,1,1,0.3
barcode14,5,70946065,G,DEL,666,7,1,6,1.05
barcode14,5,70946066,A,DEL,667,22,0,22,3.3
barcode14,5,70946067,T,DEL,668,23,1,22,3.44
barcode14,5,70946068,A,DEL,676,6,1,5,0.89
barcode14,5,70946069,A,DEL,676,5,1,4,0.74
barcode14,5,70946070,T,DEL,686,5,1,4,0.73
barcode14,5,70946071,T,DEL,687,2,0,2,0.29
barcode14,5,70946072,C,DEL,690,151,44,107,21.88
barcode14,5,70946073,C,DEL,694,15,7,8,2.16
barcode14,5,70946074,C,DEL,700,2,2,0,0.29
barcode14,5,70946075,C,DEL,700,1,0,1,0.14
barcode14,5,70946076,C,DEL,702,1,0,1,0.14
barcode14,5,70946077,A,DEL,701,1,0,1,0.14
barcode14,5,70946078,C,DEL,702,1,0,1,0.14
barcode14,5,70946081,C,DEL,701,3,1,2,0.43
barcode14,5,70946082,C,DEL,701,1,0,1,0.14
barcode14,5,70946083,T,DEL,705,1,0,1,0.14
barcode14,5,70946084,C,DEL,707,139,138,1,19.66
barcode14,5,70946086,C,DEL,708,1,1,0,0.14
barcode14,5,70946087,A,DEL,707,17,1,16,2.4
barcode14,5,70946088,T,DEL,707,17,1,16,2.4
barcode14,5,70946090,T,DEL,695,2,1,1,0.29
barcode14,5,70946091,G,DEL,695,2,1,1,0.29
barcode14,5,70946093,C,DEL,697,5,5,0,0.72
barcode14,5,70946096,G,DEL,696,4,0,4,0.57
barcode14,5,70946097,A,DEL,695,1,0,1,0.14
barcode14,5,70946098,T,DEL,699,2,0,2,0.29
barcode14,5,70946099,T,DEL,697,109,6,103,15.64
barcode14,5,70946100,C,DEL,696,111,7,104,15.95
barcode14,5,70946101,T,DEL,698,1,0,1,0.14
barcode14,5,70946102,C,DEL,697,3,1,2,0.43
barcode14,5,70946103,T,DEL,705,19,9,10,2.7
barcode14,5,70946104,T,DEL,703,13,1,12,1.85
barcode14,5,70946105,G,DEL,703,21,1,20,2.99
barcode14,5,70946106,A,DEL,712,1,1,0,0.14
barcode14,5,70946110,T,DEL,700,1,0,1,0.14
barcode14,5,70946111,G,DEL,699,1,0,1,0.14
barcode14,5,70946116,T,DEL,701,1,0,1,0.14
barcode14,5,70946118,C,DEL,698,2,0,2,0.29
barcode14,5,70946119,T,DEL,702,4,3,1,0.57
barcode14,5,70946120,T,DEL,712,1,1,0,0.14
barcode14,5,70946122,G,DEL,716,48,2,46,6.7
barcode14,5,70946125,A,DEL,721,14,2,12,1.94
barcode14,5,70946127,G,DEL,721,5,3,2,0.69
barcode14,5,70946128,T,DEL,717,18,1,17,2.51
barcode14,5,70946129,A,DEL,728,2,1,1,0.27
barcode14,5,70946130,T,DEL,728,3,2,1,0.41
barcode14,5,70946131,G,DEL,727,2,2,0,0.28
barcode14,5,70946132,T,DEL,728,87,86,1,11.95
barcode14,5,70946133,T,DEL,728,2,1,1,0.27
barcode14,5,70946134,A,DEL,725,3,2,1,0.41
barcode14,5,70946135,A,DEL,727,2,0,2,0.28
barcode14,5,70946136,T,DEL,733,13,4,9,1.77
barcode14,5,70946143,G,DEL,754,1,0,1,0.13
barcode14,5,70946144,T,DEL,753,5,0,5,0.66
barcode14,5,70946150,A,DEL,761,1,1,0,0.13
barcode14,5,70946154,G,DEL,765,2,0,2,0.26
barcode14,5,70946155,C,DEL,765,3,0,3,0.39
barcode14,5,70946156,T,DEL,764,3,0,3,0.39
barcode14,5,70946161,T,DEL,745,2,2,0,0.27
barcode14,5,70946162,A,DEL,790,1,1,0,0.13
barcode14,5,70946163,C,DEL,790,4,1,3,0.51
barcode14,5,70946166,G,DEL,797,2,0,2,0.25
barcode14,5,70946167,C,DEL,789,2,0,2,0.25
barcode14,5,70946168,T,DEL,788,4,2,2,0.51
barcode14,5,70946169,A,DEL,775,3,2,1,0.39
barcode14,5,70946170,T,DEL,775,8,7,1,1.03
barcode14,5,70946171,T,DEL,775,19,19,0,2.45
barcode14,5,70946172,A,DEL,779,19,19,0,2.44
barcode14,5,70946173,T,DEL,779,6,6,0,0.77
barcode14,5,70946174,A,DEL,800,6,6,0,0.75
barcode14,5,70946175,T,DEL,802,1,1,0,0.12
barcode14,5,70946176,G,DEL,803,1,1,0,0.12
barcode14,5,70946177,G,DEL,814,10,1,9,1.23
barcode14,5,70946178,T,DEL,816,10,0,10,1.23
barcode14,5,70946181,G,DEL,801,5,0,5,0.62
barcode14,5,70946182,T,DEL,804,5,0,5,0.62
barcode14,5,70946183,A,DEL,794,23,0,23,2.9
barcode14,5,70946186,C,DEL,800,1,0,1,0.12
barcode14,5,70946187,A,DEL,800,1,0,1,0.12
barcode14,5,70946188,C,DEL,802,1,0,1,0.12
barcode14,5,70946189,T,DEL,814,1,0,1,0.12
barcode14,5,70946190,C,DEL,812,34,3,31,4.19
barcode14,5,70946191,A,DEL,819,1,1,0,0.12
barcode14,5,70946192,G,DEL,819,2,2,0,0.24
barcode14,5,70946195,T,DEL,822,1,1,0,0.12
barcode14,5,70946196,C,DEL,824,3,0,3,0.36
barcode14,5,70946197,T,DEL,829,199,182,17,24.0
barcode14,5,70946198,T,DEL,829,18,18,0,2.17
barcode14,5,70946200,T,DEL,829,1,0,1,0.12
barcode14,5,70946201,C,DEL,830,1,0,1,0.12
barcode14,5,70946203,T,DEL,830,1,1,0,0.12
barcode14,5,70946204,G,DEL,833,15,1,14,1.8
barcode14,5,70946205,A,DEL,833,1,1,0,0.12
barcode14,5,70946206,C,DEL,832,2,1,1,0.24
barcode14,5,70946209,T,DEL,834,50,45,5,6.0
barcode14,5,70946210,T,DEL,837,2,2,0,0.24
barcode14,5,70946214,T,DEL,856,1,1,0,0.12
barcode14,5,70946215,T,DEL,857,2,1,1,0.23
barcode14,5,70946216,G,DEL,870,3,2,1,0.34
barcode14,5,70946226,G,DEL,874,1,0,1,0.11
barcode14,5,70946228,C,DEL,876,1,1,0,0.11
barcode14,5,70946229,T,DEL,876,14,14,0,1.6
barcode14,5,70946230,T,DEL,872,2,2,0,0.23
barcode14,5,70946231,T,DEL,871,2,2,0,0.23
barcode14,5,70946232,G,DEL,872,4,4,0,0.46
barcode14,5,70946233,T,DEL,872,24,22,2,2.75
barcode14,5,70946234,T,DEL,871,1,1,0,0.11
barcode14,5,70946237,G,DEL,859,2,1,1,0.23
barcode14,5,70946238,T,DEL,858,2,0,2,0.23
barcode14,5,70946239,A,DEL,851,14,11,3,1.65
barcode14,5,70946242,T,DEL,847,20,2,18,2.36
barcode14,5,70946244,T,DEL,846,6,6,0,0.71
barcode14,5,70946245,A,DEL,839,13,12,1,1.55
barcode14,5,70946246,T,DEL,839,5,4,1,0.6
barcode14,5,70946247,A,DEL,838,26,14,12,3.1
barcode14,5,70946248,A,DEL,836,4,0,4,0.48
barcode14,5,70946250,A,DEL,835,1,1,0,0.12
barcode14,5,70946251,T,DEL,834,1,1,0,0.12
barcode14,5,70946252,A,DEL,832,1,1,0,0.12
barcode14,5,70946253,C,DEL,832,5,5,0,0.6
barcode14,5,70946255,A,DEL,831,2,2,0,0.24
barcode14,5,70946256,C,DEL,831,1,1,0,0.12
barcode14,5,70946257,T,DEL,831,4,3,1,0.48
barcode14,5,70946260,C,DEL,825,2,2,0,0.24
barcode14,5,70946261,T,DEL,825,16,16,0,1.94
barcode14,5,70946262,T,DEL,824,15,12,3,1.82
barcode14,5,70946263,C,DEL,822,16,13,3,1.95
barcode14,5,70946266,T,DEL,814,8,2,6,0.98
barcode14,5,70946267,C,DEL,802,9,5,4,1.12
barcode14,5,70946268,T,DEL,797,88,81,7,11.04
barcode14,5,70946269,T,DEL,794,8,1,7,1.01
barcode14,5,70946270,T,DEL,791,7,1,6,0.88
barcode14,5,70946271,A,DEL,783,1,1,0,0.13
barcode14,5,70946272,T,DEL,783,1,0,1,0.13
barcode14,5,70946273,A,DEL,776,4,4,0,0.52
barcode14,5,70946274,T,DEL,776,8,8,0,1.03
barcode14,5,70946275,T,DEL,776,6,6,0,0.77
barcode14,5,70946276,A,DEL,773,12,12,0,1.55
barcode14,5,70946277,C,DEL,769,6,6,0,0.78
barcode14,5,70946279,A,DEL,761,16,10,6,2.1
barcode14,5,70946286,A,DEL,736,32,31,1,4.35
barcode14,5,70946290,A,DEL,732,1,1,0,0.14
barcode14,5,70946291,T,DEL,731,2,2,0,0.27
barcode14,5,70946292,A,DEL,721,103,99,4,14.29
barcode14,5,70946293,A,DEL,721,33,33,0,4.58
barcode14,5,70946294,A,DEL,714,9,9,0,1.26
barcode14,5,70946295,A,DEL,709,1,1,0,0.14
barcode14,5,70946301,C,DEL,676,2,2,0,0.3
barcode14,5,70946302,A,DEL,664,3,3,0,0.45
barcode14,5,70946305,T,DEL,648,1,1,0,0.15
barcode14,5,70946306,G,DEL,639,1,1,0,0.16
barcode14,5,70946307,T,DEL,635,2,2,0,0.31
barcode14,5,70946308,C,DEL,556,6,5,1,1.08
barcode14,5,70946309,T,DEL,552,2,0,2,0.36
barcode14,5,70946315,T,DEL,424,2,2,0,0.47
barcode14,5,70951943,T,DEL,786,17,0,17,2.16
barcode14,5,70951946,C,DEL,818,3,0,3,0.37
barcode14,5,70951948,G,DEL,823,8,2,6,0.97
barcode14,5,70951949,A,DEL,831,6,0,6,0.72
barcode14,5,70951950,C,DEL,831,7,0,7,0.84
barcode14,5,70951951,A,DEL,832,140,2,138,16.83
barcode14,5,70951952,A,DEL,836,2,0,2,0.24
barcode14,5,70951953,A,DEL,837,1,0,1,0.12
barcode14,5,70951956,C,DEL,844,1,0,1,0.12
barcode14,5,70951957,A,DEL,844,119,17,102,14.1
barcode14,5,70951958,A,DEL,848,20,1,19,2.36
barcode14,5,70951959,A,DEL,851,2,0,2,0.24
barcode14,5,70951960,A,DEL,854,2,0,2,0.23
barcode14,5,70951961,A,DEL,856,2,0,2,0.23
barcode14,5,70951962,G,DEL,857,4,2,2,0.47
barcode14,5,70951963,A,DEL,870,41,3,38,4.71
barcode14,5,70951964,A,DEL,874,2,2,0,0.23
barcode14,5,70951965,G,DEL,876,2,2,0,0.23
barcode14,5,70951967,A,DEL,883,57,1,56,6.46
barcode14,5,70951969,G,DEL,884,1,1,0,0.11
barcode14,5,70951973,C,DEL,895,13,0,13,1.45
barcode14,5,70951975,C,DEL,908,7,0,7,0.77
barcode14,5,70951976,A,DEL,909,5,0,5,0.55
barcode14,5,70951977,C,DEL,914,2,0,2,0.22
barcode14,5,70951978,A,DEL,917,4,0,4,0.44
barcode14,5,70951979,T,DEL,922,4,2,2,0.43
barcode14,5,70951980,T,DEL,923,2,0,2,0.22
barcode14,5,70951981,C,DEL,925,4,0,4,0.43
barcode14,5,70951982,C,DEL,928,2,0,2,0.22
barcode14,5,70951983,T,DEL,928,19,10,9,2.05
barcode14,5,70951984,T,DEL,932,8,0,8,0.86
barcode14,5,70951985,A,DEL,933,29,16,13,3.11
barcode14,5,70951988,T,DEL,940,2,1,1,0.21
barcode14,5,70951989,T,DEL,940,1,1,0,0.11
barcode14,5,70951990,A,DEL,946,20,1,19,2.11
barcode14,5,70951991,A,DEL,948,1,1,0,0.11
barcode14,5,70951992,G,DEL,951,1,1,0,0.11
barcode14,5,70951993,G,DEL,958,1,1,0,0.1
barcode14,5,70951994,A,DEL,965,3,1,2,0.31
barcode14,5,70951995,G,DEL,966,7,2,5,0.72
barcode14,5,70951996,T,DEL,967,4,1,3,0.41
barcode14,5,70951997,A,DEL,969,3,0,3,0.31
barcode14,5,70951998,A,DEL,974,1,0,1,0.1
barcode14,5,70952000,T,DEL,987,3,2,1,0.3
barcode14,5,70952001,C,DEL,990,10,4,6,1.01
barcode14,5,70952002,T,DEL,1000,12,0,12,1.2
barcode14,5,70952003,G,DEL,1047,2,0,2,0.19
barcode14,5,70952004,C,DEL,1073,13,8,5,1.21
barcode14,5,70952005,C,DEL,1072,4,0,4,0.37
barcode14,5,70952007,G,DEL,1081,2,0,2,0.19
barcode14,5,70952008,C,DEL,1077,4,0,4,0.37
barcode14,5,70952009,A,DEL,1079,2,1,1,0.19
barcode14,5,70952010,T,DEL,1080,4,3,1,0.37
barcode14,5,70952011,T,DEL,1082,6,5,1,0.55
barcode14,5,70952012,A,DEL,1092,5,4,1,0.46
barcode14,5,70952013,T,DEL,1091,1,0,1,0.09
barcode14,5,70952014,G,DEL,1095,4,0,4,0.37
barcode14,5,70952015,A,DEL,1099,162,26,136,14.74
barcode14,5,70952020,G,DEL,1104,3,0,3,0.27
barcode14,5,70952021,A,DEL,1103,1,0,1,0.09
barcode14,5,70952023,T,DEL,1101,6,3,3,0.54
barcode14,5,70952024,C,DEL,1099,5,4,1,0.45
barcode14,5,70952025,T,DEL,1103,7,5,2,0.63
barcode14,5,70952026,T,DEL,1104,1,0,1,0.09
barcode14,5,70952027,A,DEL,1113,2,2,0,0.18
barcode14,5,70952028,C,DEL,1112,2,2,0,0.18
barcode14,5,70952029,T,DEL,1116,86,6,80,7.71
barcode14,5,70952030,T,DEL,1120,1,1,0,0.09
barcode14,5,70952031,T,DEL,1118,2,2,0,0.18
barcode14,5,70952032,T,DEL,1115,5,5,0,0.45
barcode14,5,70952033,G,DEL,1123,8,6,2,0.71
barcode14,5,70952034,T,DEL,1126,21,0,21,1.87
barcode14,5,70952035,A,DEL,1128,13,4,9,1.15
barcode14,5,70952036,A,DEL,1131,4,0,4,0.35
barcode14,5,70952037,A,DEL,1130,1,0,1,0.09
barcode14,5,70952038,A,DEL,1124,1,0,1,0.09
barcode14,5,70952039,C,DEL,1125,1,1,0,0.09
barcode14,5,70952040,T,DEL,1130,9,4,5,0.8
barcode14,5,70952041,T,DEL,1131,1,0,1,0.09
barcode14,5,70952042,T,DEL,1130,1,0,1,0.09
barcode14,5,70952043,A,DEL,1139,1,0,1,0.09
barcode14,5,70952044,T,DEL,1139,1,0,1,0.09
barcode14,5,70952045,G,DEL,1140,1,0,1,0.09
barcode14,5,70952047,T,DEL,1143,4,0,4,0.35
barcode14,5,70952049,T,DEL,1151,2,0,2,0.17
barcode14,5,70952050,G,DEL,1218,2,0,2,0.16
barcode14,5,70952051,T,DEL,1223,1,0,1,0.08
barcode14,5,70952052,G,DEL,1225,13,11,2,1.06
barcode14,5,70952054,A,DEL,1231,11,0,11,0.89
barcode14,5,70952056,A,DEL,1211,1,0,1,0.08
barcode14,5,70952057,A,DEL,1211,2,0,2,0.17
barcode14,5,70952058,C,DEL,1212,2,0,2,0.17
barcode14,5,70952059,A,DEL,1211,69,0,69,5.7
barcode14,5,70952062,T,DEL,1225,2,2,0,0.16
barcode14,5,70952063,G,DEL,1220,3,3,0,0.25
barcode14,5,70952064,T,DEL,1219,57,13,44,4.68
barcode14,5,70952065,T,DEL,1220,2,0,2,0.16
barcode14,5,70952068,T,DEL,1225,1,0,1,0.08
barcode14,5,70952069,G,DEL,1222,8,1,7,0.65
barcode14,5,70952070,A,DEL,1238,15,0,15,1.21
barcode14,5,70952071,A,DEL,1234,2,0,2,0.16
barcode14,5,70952072,C,DEL,1236,3,2,1,0.24
barcode14,5,70952074,T,DEL,1236,5,2,3,0.4
barcode14,5,70952075,T,DEL,1234,1,1,0,0.08
barcode14,5,70952076,T,DEL,1232,5,0,5,0.41
barcode14,5,70952077,A,DEL,1233,113,6,107,9.16
barcode14,5,70952078,A,DEL,1235,25,1,24,2.02
barcode14,5,70952079,A,DEL,1232,1,0,1,0.08
barcode14,5,70952081,A,DEL,1231,2,0,2,0.16
barcode14,5,70952082,G,DEL,1231,4,0,4,0.32
barcode14,5,70952083,T,DEL,1237,45,45,0,3.64
barcode14,5,70952084,T,DEL,1237,8,8,0,0.65
barcode14,5,70952085,C,DEL,1238,23,16,7,1.86
barcode14,5,70952086,A,DEL,1245,35,1,34,2.81
barcode14,5,70952087,G,DEL,1243,41,3,38,3.3
barcode14,5,70952088,A,DEL,1238,3,1,2,0.24
barcode14,5,70952089,T,DEL,1238,3,1,2,0.24
barcode14,5,70952090,G,DEL,1247,1,1,0,0.08
barcode14,5,70952091,T,DEL,1239,20,20,0,1.61
barcode14,5,70952092,T,DEL,1274,1,1,0,0.08
barcode14,5,70952093,A,DEL,1290,49,3,46,3.8
barcode14,5,70952094,A,DEL,1268,8,2,6,0.63
barcode14,5,70952097,A,DEL,1270,1,0,1,0.08
barcode14,5,70952098,G,DEL,1269,4,1,3,0.32
barcode14,5,70952099,T,DEL,1269,10,7,3,0.79
barcode14,5,70952101,G,DEL,1267,4,0,4,0.32
barcode14,5,70952102,A,DEL,1285,75,0,75,5.84
barcode14,5,70952103,A,DEL,1288,1,0,1,0.08
barcode14,5,70952105,G,DEL,1286,1,0,1,0.08
barcode14,5,70952107,T,DEL,1294,7,7,0,0.54
barcode14,5,70952109,A,DEL,1302,5,1,4,0.38
barcode14,5,70952110,A,DEL,1301,1,1,0,0.08
barcode14,5,70952111,T,DEL,1299,4,1,3,0.31
barcode14,5,70952112,G,DEL,1298,2,1,1,0.15
barcode14,5,70952113,T,DEL,1290,28,1,27,2.17
barcode14,5,70952114,A,DEL,1286,6,2,4,0.47
barcode14,5,70952122,C,DEL,1232,1,0,1,0.08
barcode14,5,70952123,A,DEL,1223,3,0,3,0.25
barcode14,5,70952124,A,DEL,1218,1,1,0,0.08
barcode14,5,70952125,T,DEL,1214,1,1,0,0.08
barcode14,5,70952126,A,DEL,1216,4,2,2,0.33
barcode14,5,70952127,T,DEL,1214,14,14,0,1.15
barcode14,5,70952129,A,DEL,1213,12,3,9,0.99
barcode14,5,70952130,A,DEL,1213,2,1,1,0.16
barcode14,5,70952131,A,DEL,1207,1,1,0,0.08
barcode14,5,70952132,G,DEL,1197,6,6,0,0.5
barcode14,5,70952133,A,DEL,1192,1,1,0,0.08
barcode14,5,70952135,T,DEL,1182,113,66,47,9.56
barcode14,5,70952139,G,DEL,1167,1,0,1,0.09
barcode14,5,70952143,C,DEL,1167,19,17,2,1.63
barcode14,5,70952145,A,DEL,1153,4,1,3,0.35
barcode14,5,70952149,C,DEL,1140,1,1,0,0.09
barcode14,5,70952150,T,DEL,1140,4,3,1,0.35
barcode14,5,70952151,A,DEL,1131,1,1,0,0.09
barcode14,5,70952152,T,DEL,1131,7,7,0,0.62
barcode14,5,70952154,A,DEL,1107,3,1,2,0.27
barcode14,5,70952155,G,DEL,1101,8,4,4,0.73
barcode14,5,70952157,T,DEL,1098,1,0,1,0.09
barcode14,5,70952158,A,DEL,1086,28,18,10,2.58
barcode14,5,70952159,A,DEL,1085,1,0,1,0.09
barcode14,5,70952164,T,DEL,1074,3,3,0,0.28
barcode14,5,70952169,C,DEL,1030,2,0,2,0.19
barcode14,5,70952170,T,DEL,1025,7,0,7,0.68
barcode14,5,70952171,A,DEL,1010,1,0,1,0.1
barcode14,5,70952172,C,DEL,998,1,0,1,0.1
barcode14,5,70952174,T,DEL,982,6,1,5,0.61
barcode14,5,70952175,C,DEL,965,10,7,3,1.04
barcode14,5,70952176,C,DEL,962,1,1,0,0.1
barcode14,5,70952177,C,DEL,960,2,1,1,0.21
barcode14,5,70952178,T,DEL,942,10,1,9,1.06
barcode14,5,70952179,A,DEL,924,8,8,0,0.87
barcode14,5,70952180,C,DEL,916,1,0,1,0.11
barcode14,5,70952181,T,DEL,913,1,0,1,0.11
barcode14,5,70952182,A,DEL,895,9,9,0,1.01
barcode14,5,70952186,T,DEL,874,2,2,0,0.23
barcode14,5,70952188,C,DEL,858,2,1,1,0.23
barcode14,5,70952189,T,DEL,844,1,0,1,0.12
barcode14,5,70952192,T,DEL,822,1,0,1,0.12
barcode14,5,70952193,A,DEL,787,2,2,0,0.25
barcode14,5,70952194,C,DEL,718,1,1,0,0.14
barcode14,5,70952195,T,DEL,713,6,6,0,0.84
barcode14,5,70952201,G,DEL,617,1,1,0,0.16
barcode14,5,70952203,T,DEL,611,4,4,0,0.65
barcode12,5,70924554,A,DEL,1,1,0,1,100.0
barcode12,5,70924564,T,DEL,1,1,0,1,100.0
barcode12,5,70924860,A,DEL,551,28,0,28,5.08
barcode12,5,70924864,C,DEL,940,2,0,2,0.21
barcode12,5,70924865,A,DEL,991,10,0,10,1.01
barcode12,5,70924868,C,DEL,1049,10,1,9,0.95
barcode12,5,70924869,A,DEL,1075,13,0,13,1.21
barcode12,5,70924870,A,DEL,1076,4,0,4,0.37
barcode12,5,70924871,A,DEL,1079,13,1,12,1.2
barcode12,5,70924872,C,DEL,1082,47,4,43,4.34
barcode12,5,70924873,A,DEL,1085,301,26,275,27.74
barcode12,5,70924874,A,DEL,1096,133,10,123,12.14
barcode12,5,70924875,A,DEL,1103,48,1,47,4.35
barcode12,5,70924876,A,DEL,1109,12,1,11,1.08
barcode12,5,70924877,A,DEL,1113,9,0,9,0.81
barcode12,5,70924878,A,DEL,1120,3,0,3,0.27
barcode12,5,70924879,A,DEL,1135,1,0,1,0.09
barcode12,5,70924881,A,DEL,1152,1,1,0,0.09
barcode12,5,70924882,A,DEL,1160,2,1,1,0.17
barcode12,5,70924883,G,DEL,1163,3,1,2,0.26
barcode12,5,70924884,G,DEL,1171,1,0,1,0.09
barcode12,5,70924885,A,DEL,1187,44,0,44,3.71
barcode12,5,70924886,A,DEL,1191,1,0,1,0.08
barcode12,5,70924887,A,DEL,1201,1,0,1,0.08
barcode12,5,70924888,G,DEL,1204,1,0,1,0.08
barcode12,5,70924889,G,DEL,1216,1,0,1,0.08
barcode12,5,70924890,A,DEL,1229,18,3,15,1.46
barcode12,5,70924891,A,DEL,1230,4,0,4,0.33
barcode12,5,70924892,A,DEL,1244,4,3,1,0.32
barcode12,5,70924893,T,DEL,1245,5,3,2,0.4
barcode12,5,70924895,T,DEL,1274,3,0,3,0.24
barcode12,5,70924896,A,DEL,1291,8,0,8,0.62
barcode12,5,70924898,C,DEL,1357,1,1,0,0.07
barcode12,5,70924902,G,DEL,1539,3,0,3,0.19
barcode12,5,70924903,T,DEL,1543,1,0,1,0.06
barcode12,5,70924905,A,DEL,1568,43,0,43,2.74
barcode12,5,70924909,G,DEL,1610,1,0,1,0.06
barcode12,5,70924910,A,DEL,1638,31,0,31,1.89
barcode12,5,70924911,A,DEL,1652,1,0,1,0.06
barcode12,5,70924913,G,DEL,1660,1,0,1,0.06
barcode12,5,70924915,A,DEL,1699,2,2,0,0.12
barcode12,5,70924916,T,DEL,1701,9,9,0,0.53
barcode12,5,70924917,T,DEL,1708,2,2,0,0.12
barcode12,5,70924918,G,DEL,1719,16,13,3,0.93
barcode12,5,70924919,A,DEL,1793,16,13,3,0.89
barcode12,5,70924920,G,DEL,1813,4,3,1,0.22
barcode12,5,70924921,A,DEL,1841,6,5,1,0.33
barcode12,5,70924922,G,DEL,1842,9,0,9,0.49
barcode12,5,70924923,A,DEL,1856,7,3,4,0.38
barcode12,5,70924924,A,DEL,1869,2,1,1,0.11
barcode12,5,70924926,T,DEL,1874,2,1,1,0.11
barcode12,5,70924927,G,DEL,1877,9,0,9,0.48
barcode12,5,70924928,A,DEL,1903,133,19,114,6.99
barcode12,5,70924929,A,DEL,1911,3,0,3,0.16
barcode12,5,70924931,A,DEL,1912,10,10,0,0.52
barcode12,5,70924932,A,DEL,1913,15,14,1,0.78
barcode12,5,70924933,T,DEL,1916,19,14,5,0.99
barcode12,5,70924935,T,DEL,1955,2,1,1,0.1
barcode12,5,70924936,A,DEL,1983,3,1,2,0.15
barcode12,5,70924937,C,DEL,2000,2,0,2,0.1
barcode12,5,70924938,A,DEL,2015,2,0,2,0.1
barcode12,5,70924939,C,DEL,2024,2,0,2,0.1
barcode12,5,70924940,G,DEL,2054,1,0,1,0.05
barcode12,5,70924941,C,DEL,2070,8,2,6,0.39
barcode12,5,70924942,C,DEL,2072,6,2,4,0.29
barcode12,5,70924943,A,DEL,2079,7,3,4,0.34
barcode12,5,70924944,C,DEL,2085,10,2,8,0.48
barcode12,5,70924945,A,DEL,2080,41,13,28,1.97
barcode12,5,70924946,A,DEL,2090,3,1,2,0.14
barcode12,5,70924947,A,DEL,2093,3,0,3,0.14
barcode12,5,70924948,T,DEL,2094,5,0,5,0.24
barcode12,5,70924949,G,DEL,2107,4,0,4,0.19
barcode12,5,70924950,T,DEL,2117,4,3,1,0.19
barcode12,5,70924951,G,DEL,2127,466,44,422,21.91
barcode12,5,70924952,G,DEL,2149,1,1,0,0.05
barcode12,5,70924953,G,DEL,2152,1,0,1,0.05
barcode12,5,70924954,A,DEL,2168,4,2,2,0.18
barcode12,5,70924955,G,DEL,2171,7,2,5,0.32
barcode12,5,70924959,G,DEL,2196,8,0,8,0.36
barcode12,5,70924962,A,DEL,2234,22,2,20,0.98
barcode12,5,70924963,A,DEL,2242,1,1,0,0.04
barcode12,5,70924964,C,DEL,2242,2,2,0,0.09
barcode12,5,70924966,A,DEL,2264,1,1,0,0.04
barcode12,5,70924967,C,DEL,2266,9,1,8,0.4
barcode12,5,70924968,T,DEL,2269,51,2,49,2.25
barcode12,5,70924969,C,DEL,2274,12,0,12,0.53
barcode12,5,70924970,G,DEL,2272,12,0,12,0.53
barcode12,5,70924971,T,DEL,2286,37,0,37,1.62
barcode12,5,70924972,A,DEL,2294,30,8,22,1.31
barcode12,5,70924973,G,DEL,2295,39,12,27,1.7
barcode12,5,70924974,A,DEL,2328,18,3,15,0.77
barcode12,5,70924977,G,DEL,2332,1,0,1,0.04
barcode12,5,70924978,C,DEL,2335,1,0,1,0.04
barcode12,5,70924979,G,DEL,2335,2,0,2,0.09
barcode12,5,70924981,G,DEL,2333,35,28,7,1.5
barcode12,5,70924982,A,DEL,2345,5,0,5,0.21
barcode12,5,70924983,G,DEL,2350,15,7,8,0.64
barcode12,5,70924984,A,DEL,2349,21,13,8,0.89
barcode12,5,70924987,T,DEL,2347,5,5,0,0.21
barcode12,5,70924988,T,DEL,2351,19,19,0,0.81
barcode12,5,70924989,A,DEL,2354,22,22,0,0.93
barcode12,5,70924990,C,DEL,2357,20,20,0,0.85
barcode12,5,70924991,T,DEL,2366,3,1,2,0.13
barcode12,5,70924992,A,DEL,2389,5,3,2,0.21
barcode12,5,70924993,C,DEL,2389,10,3,7,0.42
barcode12,5,70924994,A,DEL,2393,9,5,4,0.38
barcode12,5,70924996,G,DEL,2413,4,1,3,0.17
barcode12,5,70924997,C,DEL,2415,2,0,2,0.08
barcode12,5,70925000,T,DEL,2405,102,0,102,4.24
barcode12,5,70925001,C,DEL,2406,123,2,121,5.11
barcode12,5,70925002,C,DEL,2412,23,1,22,0.95
barcode12,5,70925003,T,DEL,2424,21,3,18,0.87
barcode12,5,70925004,C,DEL,2442,275,210,65,11.26
barcode12,5,70925005,C,DEL,2456,4,2,2,0.16
barcode12,5,70925006,C,DEL,2456,3,2,1,0.12
barcode12,5,70925007,G,DEL,2458,4,3,1,0.16
barcode12,5,70925008,G,DEL,2465,1,0,1,0.04
barcode12,5,70925009,C,DEL,2452,1,1,0,0.04
barcode12,5,70925010,C,DEL,2448,1,1,0,0.04
barcode12,5,70925011,A,DEL,2462,1,1,0,0.04
barcode12,5,70925012,C,DEL,2469,6,5,1,0.24
barcode12,5,70925014,G,DEL,2465,4,2,2,0.16
barcode12,5,70925015,T,DEL,2464,5,1,4,0.2
barcode12,5,70925016,A,DEL,2466,1,0,1,0.04
barcode12,5,70925017,C,DEL,2472,6,5,1,0.24
barcode12,5,70925018,T,DEL,2472,1,0,1,0.04
barcode12,5,70925019,G,DEL,2474,3,1,2,0.12
barcode12,5,70925020,T,DEL,2475,155,10,145,6.26
barcode12,5,70925021,T,DEL,2485,4,0,4,0.16
barcode12,5,70925022,C,DEL,2499,20,3,17,0.8
barcode12,5,70925023,C,DEL,2504,3,3,0,0.12
barcode12,5,70925024,G,DEL,2506,3,2,1,0.12
barcode12,5,70925025,C,DEL,2513,3,3,0,0.12
barcode12,5,70925026,T,DEL,2521,2,2,0,0.08
barcode12,5,70925027,C,DEL,2530,321,306,15,12.69
barcode12,5,70925029,C,DEL,2544,2,2,0,0.08
barcode12,5,70925030,A,DEL,2543,11,8,3,0.43
barcode12,5,70925031,G,DEL,2541,5,3,2,0.2
barcode12,5,70925032,A,DEL,2538,5,3,2,0.2
barcode12,5,70925035,C,DEL,2537,342,239,103,13.48
barcode12,5,70925036,C,DEL,2545,1,1,0,0.04
barcode12,5,70925038,C,DEL,2545,48,43,5,1.89
barcode12,5,70925039,G,DEL,2542,116,86,30,4.56
barcode12,5,70925040,G,DEL,2548,1,1,0,0.04
barcode12,5,70925041,G,DEL,2545,1,1,0,0.04
barcode12,5,70925042,C,DEL,2541,1,1,0,0.04
barcode12,5,70925044,G,DEL,2561,1,0,1,0.04
barcode12,5,70925045,C,DEL,2564,5,2,3,0.2
barcode12,5,70925046,G,DEL,2560,14,11,3,0.55
barcode12,5,70925047,G,DEL,2554,1,0,1,0.04
barcode12,5,70925048,A,DEL,2550,207,1,206,8.12
barcode12,5,70925049,A,DEL,2527,1,1,0,0.04
barcode12,5,70925050,G,DEL,2527,1,1,0,0.04
barcode12,5,70925051,T,DEL,2528,1,1,0,0.04
barcode12,5,70925052,C,DEL,2526,1,1,0,0.04
barcode12,5,70925053,G,DEL,2531,1,0,1,0.04
barcode12,5,70925054,T,DEL,2532,1,0,1,0.04
barcode12,5,70925055,C,DEL,2535,4,0,4,0.16
barcode12,5,70925056,A,DEL,2540,1,1,0,0.04
barcode12,5,70925058,T,DEL,2542,4,0,4,0.16
barcode12,5,70925059,C,DEL,2539,10,3,7,0.39
barcode12,5,70925060,T,DEL,2544,85,44,41,3.34
barcode12,5,70925061,T,DEL,2542,28,2,26,1.1
barcode12,5,70925062,A,DEL,2534,66,12,54,2.6
barcode12,5,70925063,A,DEL,2535,9,8,1,0.36
barcode12,5,70925064,G,DEL,2531,3,2,1,0.12
barcode12,5,70925065,A,DEL,2529,61,35,26,2.41
barcode12,5,70925066,A,DEL,2526,17,16,1,0.67
barcode12,5,70925067,G,DEL,2519,81,60,21,3.22
barcode12,5,70925068,G,DEL,2508,4,4,0,0.16
barcode12,5,70925069,G,DEL,2500,3,3,0,0.12
barcode12,5,70925070,A,DEL,2488,3,3,0,0.12
barcode12,5,70925071,C,DEL,2462,6,5,1,0.24
barcode12,5,70925072,G,DEL,2453,104,93,11,4.24
barcode12,5,70925073,G,DEL,2428,4,4,0,0.16
barcode12,5,70925074,G,DEL,2406,4,4,0,0.17
barcode12,5,70925075,G,DEL,2380,89,86,3,3.74
barcode12,5,70925076,C,DEL,2376,160,149,11,6.73
barcode12,5,70925077,C,DEL,2390,71,65,6,2.97
barcode12,5,70925078,C,DEL,2385,61,60,1,2.56
barcode12,5,70925079,C,DEL,2383,24,22,2,1.01
barcode12,5,70925080,A,DEL,2376,33,28,5,1.39
barcode12,5,70925081,C,DEL,2384,5,5,0,0.21
barcode12,5,70925082,G,DEL,2386,18,15,3,0.75
barcode12,5,70925083,C,DEL,2391,5,3,2,0.21
barcode12,5,70925084,T,DEL,2389,6,2,4,0.25
barcode12,5,70925085,G,DEL,2399,14,14,0,0.58
barcode12,5,70925086,C,DEL,2392,7,7,0,0.29
barcode12,5,70925087,G,DEL,2387,1,1,0,0.04
barcode12,5,70925088,C,DEL,2396,22,10,12,0.92
barcode12,5,70925089,A,DEL,2390,16,15,1,0.67
barcode12,5,70925090,C,DEL,2389,45,37,8,1.88
barcode12,5,70925091,C,DEL,2380,5,5,0,0.21
barcode12,5,70925092,C,DEL,2372,14,13,1,0.59
barcode12,5,70925093,G,DEL,2377,17,14,3,0.72
barcode12,5,70925094,C,DEL,2378,3,1,2,0.13
barcode12,5,70925095,G,DEL,2368,21,4,17,0.89
barcode12,5,70925096,G,DEL,2360,2,1,1,0.08
barcode12,5,70925097,G,DEL,2344,2,1,1,0.09
barcode12,5,70925098,T,DEL,2346,15,12,3,0.64
barcode12,5,70925100,T,DEL,2332,4,4,0,0.17
barcode12,5,70925101,G,DEL,2335,5,5,0,0.21
barcode12,5,70925102,C,DEL,2331,8,6,2,0.34
barcode12,5,70925103,T,DEL,2323,7,3,4,0.3
barcode12,5,70925104,A,DEL,2321,3,3,0,0.13
barcode12,5,70925108,C,DEL,2283,4,0,4,0.18
barcode12,5,70925109,G,DEL,2270,12,0,12,0.53
barcode12,5,70925110,A,DEL,2273,11,0,11,0.48
barcode12,5,70925112,G,DEL,2265,8,1,7,0.35
barcode12,5,70925113,A,DEL,2260,11,3,8,0.49
barcode12,5,70925114,G,DEL,2252,29,3,26,1.29
barcode12,5,70925115,C,DEL,2253,27,2,25,1.2
barcode12,5,70925116,A,DEL,2245,1,1,0,0.04
barcode12,5,70925117,G,DEL,2245,5,3,2,0.22
barcode12,5,70925118,C,DEL,2246,5,3,2,0.22
barcode12,5,70925119,G,DEL,2237,5,3,2,0.22
barcode12,5,70925120,G,DEL,2235,1,1,0,0.04
barcode12,5,70925121,C,DEL,2229,1,1,0,0.04
barcode12,5,70925122,G,DEL,2197,1,0,1,0.05
barcode12,5,70925124,C,DEL,2154,4,1,3,0.19
barcode12,5,70925125,A,DEL,2130,20,17,3,0.94
barcode12,5,70925126,G,DEL,2130,18,15,3,0.85
barcode12,5,70925127,T,DEL,2127,15,15,0,0.71
barcode12,5,70925128,G,DEL,2125,3,3,0,0.14
barcode12,5,70925131,G,DEL,2109,22,21,1,1.04
barcode12,5,70925132,G,DEL,2106,21,20,1,1.0
barcode12,5,70925133,C,DEL,2097,21,19,2,1.0
barcode12,5,70925134,G,DEL,2081,14,4,10,0.67
barcode12,5,70925135,G,DEL,2064,3,3,0,0.15
barcode12,5,70925136,C,DEL,2050,3,3,0,0.15
barcode12,5,70925137,G,DEL,2042,4,3,1,0.2
barcode12,5,70925138,T,DEL,2034,3,3,0,0.15
barcode12,5,70925139,C,DEL,2025,82,74,8,4.05
barcode12,5,70925140,C,DEL,2024,1,0,1,0.05
barcode12,5,70925141,C,DEL,2018,4,3,1,0.2
barcode12,5,70925142,G,DEL,2004,26,20,6,1.3
barcode12,5,70925143,G,DEL,1996,8,4,4,0.4
barcode12,5,70925144,A,DEL,1983,8,7,1,0.4
barcode12,5,70925145,G,DEL,1968,28,14,14,1.42
barcode12,5,70925146,C,DEL,1965,10,7,3,0.51
barcode12,5,70925147,A,DEL,1949,37,37,0,1.9
barcode12,5,70925148,G,DEL,1947,27,26,1,1.39
barcode12,5,70925149,G,DEL,1938,20,20,0,1.03
barcode12,5,70925150,A,DEL,1921,16,14,2,0.83
barcode12,5,70925151,G,DEL,1911,24,24,0,1.26
barcode12,5,70925152,G,DEL,1899,42,42,0,2.21
barcode12,5,70925153,A,DEL,1893,42,42,0,2.22
barcode12,5,70925154,T,DEL,1891,73,66,7,3.86
barcode12,5,70925155,T,DEL,1877,2,0,2,0.11
barcode12,5,70925156,C,DEL,1875,4,2,2,0.21
barcode12,5,70925158,G,DEL,1867,8,0,8,0.43
barcode12,5,70925159,T,DEL,1863,7,0,7,0.38
barcode12,5,70925161,C,DEL,1802,3,3,0,0.17
barcode12,5,70925162,T,DEL,1798,7,0,7,0.39
barcode12,5,70925164,T,DEL,1783,28,21,7,1.57
barcode12,5,70925165,T,DEL,1771,2,2,0,0.11
barcode12,5,70925166,C,DEL,1750,16,7,9,0.91
barcode12,5,70925167,C,DEL,1742,20,6,14,1.15
barcode12,5,70925168,G,DEL,1735,60,11,49,3.46
barcode12,5,70925169,G,DEL,1715,7,7,0,0.41
barcode12,5,70925170,C,DEL,1669,3,3,0,0.18
barcode12,5,70925171,G,DEL,1639,3,3,0,0.18
barcode12,5,70925172,C,DEL,1621,3,2,1,0.19
barcode12,5,70925173,G,DEL,1603,3,2,1,0.19
barcode12,5,70925174,G,DEL,1598,1,0,1,0.06
barcode12,5,70925175,C,DEL,1590,3,2,1,0.19
barcode12,5,70925176,A,DEL,1573,6,6,0,0.38
barcode12,5,70925177,C,DEL,1568,4,4,0,0.26
barcode12,5,70925178,A,DEL,1566,12,12,0,0.77
barcode12,5,70925179,G,DEL,1565,5,5,0,0.32
barcode12,5,70925180,G,DEL,1561,1,1,0,0.06
barcode12,5,70925181,C,DEL,1558,15,15,0,0.96
barcode12,5,70925183,A,DEL,1552,2,1,1,0.13
barcode12,5,70925184,G,DEL,1536,3,0,3,0.2
barcode12,5,70925186,T,DEL,1515,1,1,0,0.07
barcode12,5,70925187,G,DEL,1504,1,0,1,0.07
barcode12,5,70925192,C,DEL,1405,4,4,0,0.28
barcode12,5,70925193,G,DEL,1397,6,4,2,0.43
barcode12,5,70925194,C,DEL,1384,11,0,11,0.79
barcode12,5,70925195,A,DEL,1351,2,2,0,0.15
barcode12,5,70925196,G,DEL,1346,2,2,0,0.15
barcode12,5,70925197,C,DEL,1338,12,12,0,0.9
barcode12,5,70925199,A,DEL,1300,2,2,0,0.15
barcode12,5,70925202,G,DEL,1255,2,2,0,0.16
barcode12,5,70925203,C,DEL,1219,1,0,1,0.08
barcode12,5,70925205,G,DEL,1192,1,1,0,0.08
barcode12,5,70925206,T,DEL,1190,3,3,0,0.25
barcode12,5,70925207,C,DEL,1129,26,4,22,2.3
barcode12,5,70925208,T,DEL,1108,1,0,1,0.09
barcode12,5,70925209,C,DEL,1098,2,2,0,0.18
barcode12,5,70925211,C,DEL,995,1,1,0,0.1
barcode12,5,70925212,T,DEL,956,2,1,1,0.21
barcode12,5,70925213,A,DEL,461,14,14,0,3.04
barcode12,5,70938767,C,DEL,473,15,0,15,3.17
barcode12,5,70938768,T,DEL,524,29,6,23,5.53
barcode12,5,70938769,T,DEL,532,3,0,3,0.56
barcode12,5,70938770,G,DEL,540,4,0,4,0.74
barcode12,5,70938772,T,DEL,559,8,0,8,1.43
barcode12,5,70938774,C,DEL,572,1,1,0,0.17
barcode12,5,70938775,T,DEL,582,1,0,1,0.17
barcode12,5,70938776,A,DEL,592,3,0,3,0.51
barcode12,5,70938781,A,DEL,619,3,3,0,0.48
barcode12,5,70938783,A,DEL,625,5,0,5,0.8
barcode12,5,70938784,T,DEL,626,26,13,13,4.15
barcode12,5,70938785,T,DEL,634,4,0,4,0.63
barcode12,5,70938786,T,DEL,638,1,0,1,0.16
barcode12,5,70938787,T,DEL,638,3,1,2,0.47
barcode12,5,70938788,C,DEL,646,6,1,5,0.93
barcode12,5,70938789,T,DEL,648,1,0,1,0.15
barcode12,5,70938790,G,DEL,653,17,0,17,2.6
barcode12,5,70938792,T,DEL,663,4,1,3,0.6
barcode12,5,70938794,A,DEL,664,18,1,17,2.71
barcode12,5,70938799,T,DEL,737,2,1,1,0.27
barcode12,5,70938801,T,DEL,751,2,0,2,0.27
barcode12,5,70938802,C,DEL,773,1,1,0,0.13
barcode12,5,70938804,G,DEL,778,21,0,21,2.7
barcode12,5,70938805,A,DEL,783,27,0,27,3.45
barcode12,5,70938807,C,DEL,849,1,1,0,0.12
barcode12,5,70938808,A,DEL,862,1,0,1,0.12
barcode12,5,70938813,T,DEL,935,1,1,0,0.11
barcode12,5,70938814,T,DEL,938,2,2,0,0.21
barcode12,5,70938815,G,DEL,951,4,3,1,0.42
barcode12,5,70938816,T,DEL,954,99,47,52,10.38
barcode12,5,70938817,T,DEL,955,31,31,0,3.25
barcode12,5,70938818,T,DEL,964,4,4,0,0.41
barcode12,5,70938819,T,DEL,964,4,4,0,0.41
barcode12,5,70938820,T,DEL,964,5,4,1,0.52
barcode12,5,70938821,A,DEL,968,6,5,1,0.62
barcode12,5,70938822,T,DEL,968,5,1,4,0.52
barcode12,5,70938823,T,DEL,972,5,5,0,0.51
barcode12,5,70938824,T,DEL,973,5,5,0,0.51
barcode12,5,70938825,C,DEL,985,5,5,0,0.51
barcode12,5,70938826,T,DEL,991,14,14,0,1.41
barcode12,5,70938827,T,DEL,995,1,0,1,0.1
barcode12,5,70938828,A,DEL,1002,3,1,2,0.3
barcode12,5,70938829,C,DEL,1003,21,2,19,2.09
barcode12,5,70938830,C,DEL,1004,1,0,1,0.1
barcode12,5,70938831,C,DEL,1008,1,1,0,0.1
barcode12,5,70938832,T,DEL,1008,23,19,4,2.28
barcode12,5,70938833,T,DEL,1012,1,1,0,0.1
barcode12,5,70938835,C,DEL,1020,4,3,1,0.39
barcode12,5,70938837,A,DEL,1031,5,4,1,0.48
barcode12,5,70938838,G,DEL,1031,2,1,1,0.19
barcode12,5,70938839,A,DEL,1036,2,2,0,0.19
barcode12,5,70938845,G,DEL,1026,1,0,1,0.1
barcode12,5,70938846,A,DEL,1025,1,0,1,0.1
barcode12,5,70938847,T,DEL,1024,6,6,0,0.59
barcode12,5,70938848,T,DEL,1025,4,4,0,0.39
barcode12,5,70938849,C,DEL,1036,9,5,4,0.87
barcode12,5,70938850,T,DEL,1037,6,4,2,0.58
barcode12,5,70938851,G,DEL,1041,9,2,7,0.86
barcode12,5,70938852,A,DEL,1043,3,1,2,0.29
barcode12,5,70938853,C,DEL,1038,2,0,2,0.19
barcode12,5,70938855,T,DEL,1036,14,10,4,1.35
barcode12,5,70938858,G,DEL,1057,53,5,48,5.01
barcode12,5,70938864,A,DEL,1052,1,0,1,0.1
barcode12,5,70938865,T,DEL,1040,1,0,1,0.1
barcode12,5,70938866,A,DEL,1070,2,1,1,0.19
barcode12,5,70938867,C,DEL,1072,1,0,1,0.09
barcode12,5,70938868,A,DEL,1061,1,0,1,0.09
barcode12,5,70938869,G,DEL,1062,8,0,8,0.75
barcode12,5,70938870,C,DEL,1071,1,0,1,0.09
barcode12,5,70938872,C,DEL,1033,2,2,0,0.19
barcode12,5,70938873,T,DEL,1032,2,2,0,0.19
barcode12,5,70938874,G,DEL,1019,1,1,0,0.1
barcode12,5,70938875,A,DEL,1019,1,1,0,0.1
barcode12,5,70938877,A,DEL,984,32,23,9,3.25
barcode12,5,70938884,T,DEL,971,2,0,2,0.21
barcode12,5,70938887,G,DEL,965,1,1,0,0.1
barcode12,5,70938889,T,DEL,955,1,0,1,0.1
barcode12,5,70938890,A,DEL,942,7,1,6,0.74
barcode12,5,70938891,A,DEL,942,1,0,1,0.11
barcode12,5,70938895,T,DEL,925,1,0,1,0.11
barcode12,5,70938896,G,DEL,918,2,1,1,0.22
barcode12,5,70938897,T,DEL,908,3,2,1,0.33
barcode12,5,70938898,G,DEL,883,1,1,0,0.11
barcode12,5,70938899,G,DEL,861,1,1,0,0.12
barcode12,5,70938900,C,DEL,857,9,1,8,1.05
barcode12,5,70938901,T,DEL,854,5,5,0,0.59
barcode12,5,70938902,T,DEL,844,3,3,0,0.36
barcode12,5,70938903,C,DEL,825,2,2,0,0.24
barcode12,5,70938904,A,DEL,825,1,1,0,0.12
barcode12,5,70938905,T,DEL,825,7,2,5,0.85
barcode12,5,70938907,T,DEL,822,4,1,3,0.49
barcode12,5,70938908,A,DEL,817,18,1,17,2.2
barcode12,5,70938909,A,DEL,815,1,1,0,0.12
barcode12,5,70938910,G,DEL,806,2,2,0,0.25
barcode12,5,70938911,G,DEL,796,1,1,0,0.13
barcode12,5,70938912,T,DEL,795,2,0,2,0.25
barcode12,5,70938913,A,DEL,784,3,0,3,0.38
barcode12,5,70938916,A,DEL,767,3,0,3,0.39
barcode12,5,70938919,T,DEL,744,20,20,0,2.69
barcode12,5,70938920,G,DEL,744,20,20,0,2.69
barcode12,5,70938921,C,DEL,738,21,21,0,2.85
barcode12,5,70938922,T,DEL,734,21,21,0,2.86
barcode12,5,70938923,T,DEL,731,3,3,0,0.41
barcode12,5,70938924,G,DEL,727,4,4,0,0.55
barcode12,5,70938925,C,DEL,709,7,3,4,0.99
barcode12,5,70938926,T,DEL,708,10,4,6,1.41
barcode12,5,70938927,T,DEL,696,1,1,0,0.14
barcode12,5,70938928,A,DEL,691,1,1,0,0.14
barcode12,5,70938929,G,DEL,687,3,3,0,0.44
barcode12,5,70938931,C,DEL,671,5,5,0,0.75
barcode12,5,70938932,G,DEL,671,2,2,0,0.3
barcode12,5,70938933,T,DEL,671,37,37,0,5.51
barcode12,5,70938935,T,DEL,659,3,3,0,0.46
barcode12,5,70938936,T,DEL,656,4,3,1,0.61
barcode12,5,70938937,C,DEL,651,7,6,1,1.08
barcode12,5,70938941,T,DEL,642,69,69,0,10.75
barcode12,5,70938944,T,DEL,617,2,2,0,0.32
barcode12,5,70938945,C,DEL,611,3,3,0,0.49
barcode12,5,70938947,C,DEL,591,1,0,1,0.17
barcode12,5,70941358,A,DEL,156,1,0,1,0.64
barcode12,5,70941362,T,DEL,213,1,0,1,0.47
barcode12,5,70941364,T,DEL,238,1,0,1,0.42
barcode12,5,70941366,C,DEL,252,1,0,1,0.4
barcode12,5,70941367,A,DEL,258,1,0,1,0.39
barcode12,5,70941368,T,DEL,263,57,1,56,21.67
barcode12,5,70941369,T,DEL,274,1,0,1,0.36
barcode12,5,70941371,T,DEL,280,1,1,0,0.36
barcode12,5,70941372,T,DEL,280,1,1,0,0.36
barcode12,5,70941373,A,DEL,290,1,1,0,0.34
barcode12,5,70941374,T,DEL,290,3,2,1,1.03
barcode12,5,70941375,T,DEL,295,1,1,0,0.34
barcode12,5,70941376,C,DEL,299,1,1,0,0.33
barcode12,5,70941377,C,DEL,299,4,1,3,1.34
barcode12,5,70941378,T,DEL,299,17,1,16,5.69
barcode12,5,70941379,A,DEL,306,1,1,0,0.33
barcode12,5,70941380,T,DEL,313,15,5,10,4.79
barcode12,5,70941383,T,DEL,322,3,0,3,0.93
barcode12,5,70941384,C,DEL,332,38,0,38,11.45
barcode12,5,70941386,T,DEL,351,20,0,20,5.7
barcode12,5,70941388,G,DEL,357,1,0,1,0.28
barcode12,5,70941393,C,DEL,383,1,1,0,0.26
barcode12,5,70941394,T,DEL,404,1,1,0,0.25
barcode12,5,70941395,C,DEL,422,6,1,5,1.42
barcode12,5,70941396,T,DEL,430,14,0,14,3.26
barcode12,5,70941397,A,DEL,441,23,0,23,5.22
barcode12,5,70941400,G,DEL,444,2,0,2,0.45
barcode12,5,70941401,A,DEL,453,2,2,0,0.44
barcode12,5,70941404,G,DEL,460,1,0,1,0.22
barcode12,5,70941407,G,DEL,486,2,1,1,0.41
barcode12,5,70941408,A,DEL,489,4,0,4,0.82
barcode12,5,70941410,A,DEL,507,1,0,1,0.2
barcode12,5,70941411,T,DEL,507,10,9,1,1.97
barcode12,5,70941412,T,DEL,510,1,1,0,0.2
barcode12,5,70941413,T,DEL,510,5,5,0,0.98
barcode12,5,70941414,G,DEL,521,13,13,0,2.5
barcode12,5,70941415,T,DEL,523,3,3,0,0.57
barcode12,5,70941416,G,DEL,526,2,1,1,0.38
barcode12,5,70941417,A,DEL,529,26,3,23,4.91
barcode12,5,70941420,C,DEL,534,1,0,1,0.19
barcode12,5,70941421,T,DEL,547,17,17,0,3.11
barcode12,5,70941423,C,DEL,571,9,9,0,1.58
barcode12,5,70941424,G,DEL,592,19,1,18,3.21
barcode12,5,70941425,G,DEL,597,1,0,1,0.17
barcode12,5,70941426,G,DEL,599,1,0,1,0.17
barcode12,5,70941427,T,DEL,606,4,0,4,0.66
barcode12,5,70941428,A,DEL,607,10,2,8,1.65
barcode12,5,70941431,C,DEL,617,9,8,1,1.46
barcode12,5,70941432,C,DEL,619,2,2,0,0.32
barcode12,5,70941433,A,DEL,620,55,9,46,8.87
barcode12,5,70941434,A,DEL,621,2,0,2,0.32
barcode12,5,70941435,A,DEL,624,1,0,1,0.16
barcode12,5,70941438,C,DEL,627,2,0,2,0.32
barcode12,5,70941439,C,DEL,633,1,1,0,0.16
barcode12,5,70941440,A,DEL,634,1,1,0,0.16
barcode12,5,70941441,C,DEL,638,1,1,0,0.16
barcode12,5,70941445,T,DEL,642,1,1,0,0.16
barcode12,5,70941446,A,DEL,639,45,9,36,7.04
barcode12,5,70941447,A,DEL,639,1,0,1,0.16
barcode12,5,70941450,G,DEL,634,1,0,1,0.16
barcode12,5,70941451,A,DEL,631,18,5,13,2.85
barcode12,5,70941452,A,DEL,631,2,1,1,0.32
barcode12,5,70941453,A,DEL,633,2,1,1,0.32
barcode12,5,70941454,A,DEL,639,2,1,1,0.31
barcode12,5,70941455,C,DEL,639,2,1,1,0.31
barcode12,5,70941456,C,DEL,638,1,1,0,0.16
barcode12,5,70941457,T,DEL,640,1,0,1,0.16
barcode12,5,70941458,G,DEL,643,2,2,0,0.31
barcode12,5,70941459,C,DEL,643,1,0,1,0.16
barcode12,5,70941460,T,DEL,643,1,0,1,0.16
barcode12,5,70941461,A,DEL,638,40,30,10,6.27
barcode12,5,70941462,A,DEL,642,24,21,3,3.74
barcode12,5,70941463,G,DEL,640,26,22,4,4.06
barcode12,5,70941464,A,DEL,641,18,15,3,2.81
barcode12,5,70941465,A,DEL,641,32,32,0,4.99
barcode12,5,70941466,G,DEL,635,47,46,1,7.4
barcode12,5,70941467,A,DEL,634,5,1,4,0.79
barcode12,5,70941468,A,DEL,634,3,0,3,0.47
barcode12,5,70941469,T,DEL,633,4,0,4,0.63
barcode12,5,70941470,A,DEL,630,23,9,14,3.65
barcode12,5,70941475,C,DEL,630,2,2,0,0.32
barcode12,5,70941476,C,DEL,627,1,1,0,0.16
barcode12,5,70941477,A,DEL,626,91,18,73,14.54
barcode12,5,70941478,A,DEL,628,12,2,10,1.91
barcode12,5,70941479,A,DEL,619,11,9,2,1.78
barcode12,5,70941480,A,DEL,614,12,9,3,1.95
barcode12,5,70941481,G,DEL,613,12,9,3,1.96
barcode12,5,70941482,A,DEL,611,14,2,12,2.29
barcode12,5,70941483,A,DEL,612,11,11,0,1.8
barcode12,5,70941484,G,DEL,609,15,15,0,2.46
barcode12,5,70941485,A,DEL,608,38,36,2,6.25
barcode12,5,70941486,A,DEL,606,1,1,0,0.17
barcode12,5,70941487,T,DEL,606,1,1,0,0.17
barcode12,5,70941488,A,DEL,605,3,1,2,0.5
barcode12,5,70941489,C,DEL,603,2,2,0,0.33
barcode12,5,70941494,G,DEL,594,1,1,0,0.17
barcode12,5,70941495,C,DEL,587,21,0,21,3.58
barcode12,5,70941496,T,DEL,585,27,24,3,4.62
barcode12,5,70941500,T,DEL,558,36,36,0,6.45
barcode12,5,70941501,T,DEL,556,1,0,1,0.18
barcode12,5,70941502,A,DEL,544,9,8,1,1.65
barcode12,5,70941503,C,DEL,540,1,0,1,0.19
barcode12,5,70941513,T,DEL,482,11,11,0,2.28
barcode12,5,70941517,A,DEL,476,6,3,3,1.26
barcode12,5,70941523,T,DEL,468,55,55,0,11.75
barcode12,5,70941524,T,DEL,463,3,3,0,0.65
barcode12,5,70941525,G,DEL,456,8,8,0,1.75
barcode12,5,70941526,A,DEL,452,2,2,0,0.44
barcode12,5,70941527,G,DEL,439,6,6,0,1.37
barcode12,5,70941528,A,DEL,432,2,2,0,0.46
barcode12,5,70941529,T,DEL,432,23,23,0,5.32
barcode12,5,70941530,T,DEL,432,1,1,0,0.23
barcode12,5,70941532,A,DEL,421,1,0,1,0.24
barcode12,5,70941535,T,DEL,419,19,19,0,4.53
barcode12,5,70942312,T,DEL,42,3,3,0,7.14
barcode12,5,70942314,C,DEL,89,1,1,0,1.12
barcode12,5,70942315,A,DEL,131,1,1,0,0.76
barcode12,5,70942320,A,DEL,198,1,0,1,0.51
barcode12,5,70942327,T,DEL,253,2,0,2,0.79
barcode12,5,70942328,G,DEL,257,1,0,1,0.39
barcode12,5,70942329,C,DEL,271,1,0,1,0.37
barcode12,5,70942333,T,DEL,276,11,2,9,3.99
barcode12,5,70942334,A,DEL,278,7,2,5,2.52
barcode12,5,70942335,T,DEL,279,1,1,0,0.36
barcode12,5,70942336,A,DEL,281,1,1,0,0.36
barcode12,5,70942339,T,DEL,287,3,0,3,1.05
barcode12,5,70942340,C,DEL,292,1,0,1,0.34
barcode12,5,70942341,T,DEL,298,25,20,5,8.39
barcode12,5,70942342,T,DEL,523,3,0,3,0.57
barcode12,5,70942343,T,DEL,524,3,0,3,0.57
barcode12,5,70942344,G,DEL,525,5,0,5,0.95
barcode12,5,70942345,A,DEL,532,2,0,2,0.38
barcode12,5,70942346,T,DEL,532,1,0,1,0.19
barcode12,5,70942348,T,DEL,538,1,1,0,0.19
barcode12,5,70942349,C,DEL,550,1,1,0,0.18
barcode12,5,70942350,T,DEL,553,48,35,13,8.68
barcode12,5,70942351,T,DEL,557,1,0,1,0.18
barcode12,5,70942352,T,DEL,560,1,0,1,0.18
barcode12,5,70942353,T,DEL,564,1,0,1,0.18
barcode12,5,70942354,G,DEL,776,1,0,1,0.13
barcode12,5,70942355,T,DEL,791,1,0,1,0.13
barcode12,5,70942359,G,DEL,911,5,3,2,0.55
barcode12,5,70942361,A,DEL,913,71,15,56,7.78
barcode12,5,70942365,T,DEL,922,6,5,1,0.65
barcode12,5,70942366,T,DEL,948,1,0,1,0.11
barcode12,5,70942367,G,DEL,955,45,19,26,4.71
barcode12,5,70942370,G,DEL,970,1,0,1,0.1
barcode12,5,70942371,A,DEL,972,3,2,1,0.31
barcode12,5,70942372,C,DEL,972,3,1,2,0.31
barcode12,5,70942373,A,DEL,976,16,2,14,1.64
barcode12,5,70942374,A,DEL,977,1,1,0,0.1
barcode12,5,70942375,A,DEL,976,1,1,0,0.1
barcode12,5,70942376,T,DEL,976,2,1,1,0.2
barcode12,5,70942377,G,DEL,977,2,1,1,0.2
barcode12,5,70942378,T,DEL,988,10,10,0,1.01
barcode12,5,70942379,T,DEL,988,2,2,0,0.2
barcode12,5,70942380,C,DEL,995,3,2,1,0.3
barcode12,5,70942381,T,DEL,995,1,1,0,0.1
barcode12,5,70942382,G,DEL,1004,17,17,0,1.69
barcode12,5,70942383,C,DEL,1010,11,11,0,1.09
barcode12,5,70942384,C,DEL,1010,1,1,0,0.1
barcode12,5,70942386,T,DEL,1010,39,35,4,3.86
barcode12,5,70942387,T,DEL,1011,1,1,0,0.1
barcode12,5,70942388,T,DEL,1011,2,2,0,0.2
barcode12,5,70942389,G,DEL,1011,3,2,1,0.3
barcode12,5,70942390,G,DEL,1013,2,2,0,0.2
barcode12,5,70942392,C,DEL,1015,13,13,0,1.28
barcode12,5,70942393,A,DEL,1018,18,3,15,1.77
barcode12,5,70942394,G,DEL,1020,17,2,15,1.67
barcode12,5,70942395,A,DEL,1024,5,3,2,0.49
barcode12,5,70942396,A,DEL,1024,1,1,0,0.1
barcode12,5,70942397,G,DEL,1024,4,4,0,0.39
barcode12,5,70942398,A,DEL,1024,31,31,0,3.03
barcode12,5,70942399,C,DEL,1024,3,3,0,0.29
barcode12,5,70942400,G,DEL,1025,4,3,1,0.39
barcode12,5,70942401,G,DEL,1025,3,3,0,0.29
barcode12,5,70942402,T,DEL,1026,70,70,0,6.82
barcode12,5,70942403,T,DEL,1027,3,3,0,0.29
barcode12,5,70942407,T,DEL,1032,57,51,6,5.52
barcode12,5,70942408,T,DEL,1056,4,4,0,0.38
barcode12,5,70942409,T,DEL,1059,2,2,0,0.19
barcode12,5,70942410,A,DEL,1076,2,2,0,0.19
barcode12,5,70942411,C,DEL,1077,44,44,0,4.09
barcode12,5,70942412,C,DEL,1081,1,1,0,0.09
barcode12,5,70942413,C,DEL,1082,2,2,0,0.18
barcode12,5,70942414,A,DEL,1082,3,3,0,0.28
barcode12,5,70942415,G,DEL,1081,3,3,0,0.28
barcode12,5,70942416,C,DEL,1079,1,1,0,0.09
barcode12,5,70942418,A,DEL,1083,8,8,0,0.74
barcode12,5,70942419,C,DEL,1083,9,9,0,0.83
barcode12,5,70942420,C,DEL,1091,4,4,0,0.37
barcode12,5,70942422,T,DEL,1097,3,3,0,0.27
barcode12,5,70942423,T,DEL,1097,1,1,0,0.09
barcode12,5,70942424,G,DEL,1121,3,2,1,0.27
barcode12,5,70942425,C,DEL,1125,3,2,1,0.27
barcode12,5,70942426,T,DEL,1131,38,38,0,3.36
barcode12,5,70942427,T,DEL,1137,1,1,0,0.09
barcode12,5,70942428,C,DEL,1149,1,1,0,0.09
barcode12,5,70942429,A,DEL,1156,7,7,0,0.61
barcode12,5,70942431,T,DEL,1155,1,1,0,0.09
barcode12,5,70942433,G,DEL,1151,2,2,0,0.17
barcode12,5,70942435,T,DEL,1149,77,75,2,6.7
barcode12,5,70942436,T,DEL,1149,10,10,0,0.87
barcode12,5,70942437,T,DEL,1143,32,32,0,2.8
barcode12,5,70942438,T,DEL,1138,105,102,3,9.23
barcode12,5,70942439,A,DEL,1142,196,187,9,17.16
barcode12,5,70942440,A,DEL,1144,110,107,3,9.62
barcode12,5,70942441,G,DEL,1146,78,75,3,6.81
barcode12,5,70942442,A,DEL,1154,60,60,0,5.2
barcode12,5,70942443,G,DEL,1155,11,10,1,0.95
barcode12,5,70942444,A,DEL,1156,21,21,0,1.82
barcode12,5,70942445,G,DEL,1152,15,15,0,1.3
barcode12,5,70942446,A,DEL,1156,14,11,3,1.21
barcode12,5,70942447,A,DEL,1164,1,1,0,0.09
barcode12,5,70942449,C,DEL,1162,1,1,0,0.09
barcode12,5,70942451,T,DEL,1199,9,6,3,0.75
barcode12,5,70942452,G,DEL,1197,9,9,0,0.75
barcode12,5,70942453,T,DEL,1198,3,3,0,0.25
barcode12,5,70942454,G,DEL,1199,2,2,0,0.17
barcode12,5,70942455,T,DEL,1197,4,4,0,0.33
barcode12,5,70942456,T,DEL,1196,1,1,0,0.08
barcode12,5,70942457,G,DEL,1206,1,1,0,0.08
barcode12,5,70942461,T,DEL,1214,2,2,0,0.16
barcode12,5,70942464,A,DEL,1219,5,4,1,0.41
barcode12,5,70942465,C,DEL,1272,3,2,1,0.24
barcode12,5,70942466,A,DEL,1271,2,2,0,0.16
barcode12,5,70942467,C,DEL,1273,1,0,1,0.08
barcode12,5,70942468,T,DEL,1269,1,0,1,0.08
barcode12,5,70942469,G,DEL,1270,2,0,2,0.16
barcode12,5,70942470,G,DEL,1269,1,0,1,0.08
barcode12,5,70942475,G,DEL,1266,3,3,0,0.24
barcode12,5,70942477,A,DEL,1262,4,1,3,0.32
barcode12,5,70942478,A,DEL,1262,1,0,1,0.08
barcode12,5,70942479,A,DEL,1259,1,1,0,0.08
barcode12,5,70942480,T,DEL,1259,2,2,0,0.16
barcode12,5,70942481,A,DEL,1230,32,28,4,2.6
barcode12,5,70942482,G,DEL,1227,10,6,4,0.81
barcode12,5,70942483,A,DEL,1229,9,9,0,0.73
barcode12,5,70942484,G,DEL,1226,30,29,1,2.45
barcode12,5,70942485,A,DEL,1223,30,30,0,2.45
barcode12,5,70942486,G,DEL,1216,88,88,0,7.24
barcode12,5,70942487,G,DEL,1215,6,6,0,0.49
barcode12,5,70942488,A,DEL,1211,4,4,0,0.33
barcode12,5,70942489,G,DEL,1210,6,4,2,0.5
barcode12,5,70942490,C,DEL,1210,4,3,1,0.33
barcode12,5,70942491,A,DEL,1204,22,15,7,1.83
barcode12,5,70942494,A,DEL,1200,5,0,5,0.42
barcode12,5,70942495,T,DEL,1200,11,6,5,0.92
barcode12,5,70942496,C,DEL,1192,8,7,1,0.67
barcode12,5,70942497,T,DEL,1192,6,4,2,0.5
barcode12,5,70942498,G,DEL,1189,4,4,0,0.34
barcode12,5,70942499,T,DEL,1189,18,18,0,1.51
barcode12,5,70942500,C,DEL,1187,6,6,0,0.51
barcode12,5,70942501,C,DEL,1188,3,3,0,0.25
barcode12,5,70942502,G,DEL,1185,10,5,5,0.84
barcode12,5,70942504,T,DEL,1188,1,1,0,0.08
barcode12,5,70942505,C,DEL,1185,2,2,0,0.17
barcode12,5,70942506,T,DEL,1185,3,1,2,0.25
barcode12,5,70942507,A,DEL,1191,6,6,0,0.5
barcode12,5,70942508,C,DEL,1194,7,7,0,0.59
barcode12,5,70942509,T,DEL,1195,54,47,7,4.52
barcode12,5,70942510,T,DEL,1208,3,0,3,0.25
barcode12,5,70942511,T,DEL,1207,186,183,3,15.41
barcode12,5,70942512,C,DEL,1207,496,490,6,41.09
barcode12,5,70942513,C,DEL,1313,40,40,0,3.05
barcode12,5,70942514,C,DEL,1317,3,3,0,0.23
barcode12,5,70942515,C,DEL,1319,1,1,0,0.08
barcode12,5,70942518,T,DEL,1319,4,3,1,0.3
barcode12,5,70942519,C,DEL,1351,3,3,0,0.22
barcode12,5,70942522,T,DEL,1357,3,3,0,0.22
barcode12,5,70942524,A,DEL,1355,4,0,4,0.3
barcode12,5,70942526,G,DEL,1349,2,2,0,0.15
barcode12,5,70942532,A,DEL,1324,4,1,3,0.3
barcode12,5,70942533,A,DEL,1320,1,1,0,0.08
barcode12,5,70942535,A,DEL,1311,1,1,0,0.08
barcode12,5,70942536,A,DEL,1308,3,3,0,0.23
barcode12,5,70942537,T,DEL,1307,4,3,1,0.31
barcode12,5,70942539,T,DEL,1287,4,4,0,0.31
barcode12,5,70942540,A,DEL,1281,5,4,1,0.39
barcode12,5,70942541,G,DEL,1269,21,20,1,1.65
barcode12,5,70942542,A,DEL,1268,4,3,1,0.32
barcode12,5,70942543,A,DEL,1260,1,1,0,0.08
barcode12,5,70942544,C,DEL,1259,1,1,0,0.08
barcode12,5,70942545,A,DEL,1251,3,3,0,0.24
barcode12,5,70942546,A,DEL,1248,2,2,0,0.16
barcode12,5,70942547,A,DEL,1248,1,1,0,0.08
barcode12,5,70942550,G,DEL,1246,1,1,0,0.08
barcode12,5,70942554,A,DEL,1231,2,0,2,0.16
barcode12,5,70942557,A,DEL,1223,42,42,0,3.43
barcode12,5,70942563,G,DEL,1193,1,1,0,0.08
barcode12,5,70942565,A,DEL,1171,1,1,0,0.09
barcode12,5,70942568,C,DEL,1150,1,1,0,0.09
barcode12,5,70942569,A,DEL,1132,164,163,1,14.49
barcode12,5,70942570,A,DEL,1129,132,131,1,11.69
barcode12,5,70942571,A,DEL,1128,88,87,1,7.8
barcode12,5,70942572,A,DEL,1121,27,27,0,2.41
barcode12,5,70942587,T,DEL,341,1,1,0,0.29
barcode12,5,70942678,A,DEL,474,5,1,4,1.05
barcode12,5,70942679,C,DEL,569,1,0,1,0.18
barcode12,5,70942686,A,DEL,639,1,0,1,0.16
barcode12,5,70942687,A,DEL,641,1,0,1,0.16
barcode12,5,70942688,C,DEL,645,1,0,1,0.16
barcode12,5,70942689,A,DEL,646,31,6,25,4.8
barcode12,5,70942690,A,DEL,649,1,0,1,0.15
barcode12,5,70942698,C,DEL,660,1,0,1,0.15
barcode12,5,70942699,A,DEL,661,1,0,1,0.15
barcode12,5,70942700,T,DEL,661,5,0,5,0.76
barcode12,5,70942701,A,DEL,664,7,0,7,1.05
barcode12,5,70942702,T,DEL,664,21,1,20,3.16
barcode12,5,70942703,T,DEL,666,8,0,8,1.2
barcode12,5,70942704,T,DEL,666,6,0,6,0.9
barcode12,5,70942705,T,DEL,668,6,0,6,0.9
barcode12,5,70942706,T,DEL,669,16,0,16,2.39
barcode12,5,70942707,T,DEL,670,30,0,30,4.48
barcode12,5,70942708,C,DEL,670,38,0,38,5.67
barcode12,5,70942709,T,DEL,670,92,5,87,13.73
barcode12,5,70942710,T,DEL,670,17,3,14,2.54
barcode12,5,70942711,T,DEL,673,2,0,2,0.3
barcode12,5,70942712,T,DEL,674,2,0,2,0.3
barcode12,5,70942713,T,DEL,675,6,0,6,0.89
barcode12,5,70942714,A,DEL,679,27,0,27,3.98
barcode12,5,70942718,A,DEL,686,11,0,11,1.6
barcode12,5,70942721,G,DEL,687,8,0,8,1.16
barcode12,5,70942722,A,DEL,689,72,10,62,10.45
barcode12,5,70942723,A,DEL,689,3,0,3,0.44
barcode12,5,70942727,G,DEL,693,36,0,36,5.19
barcode12,5,70942728,A,DEL,703,4,0,4,0.57
barcode12,5,70942729,A,DEL,703,1,0,1,0.14
barcode12,5,70942731,G,DEL,707,1,0,1,0.14
barcode12,5,70942732,C,DEL,709,2,0,2,0.28
barcode12,5,70942733,C,DEL,710,1,0,1,0.14
barcode12,5,70942734,A,DEL,710,9,0,9,1.27
barcode12,5,70942736,G,DEL,709,3,0,3,0.42
barcode12,5,70942737,T,DEL,713,11,4,7,1.54
barcode12,5,70942740,C,DEL,719,1,0,1,0.14
barcode12,5,70942741,A,DEL,721,2,0,2,0.28
barcode12,5,70942743,C,DEL,719,5,0,5,0.7
barcode12,5,70942745,G,DEL,720,3,0,3,0.42
barcode12,5,70942746,A,DEL,723,6,0,6,0.83
barcode12,5,70942748,G,DEL,724,1,0,1,0.14
barcode12,5,70942749,A,DEL,728,60,2,58,8.24
barcode12,5,70942754,G,DEL,719,3,0,3,0.42
barcode12,5,70942755,A,DEL,719,6,0,6,0.83
barcode12,5,70942756,G,DEL,718,9,2,7,1.25
barcode12,5,70942757,A,DEL,724,28,0,28,3.87
barcode12,5,70942761,C,DEL,747,5,0,5,0.67
barcode12,5,70942764,G,DEL,753,9,7,2,1.2
barcode12,5,70942765,G,DEL,749,1,0,1,0.13
barcode12,5,70942766,T,DEL,752,18,0,18,2.39
barcode12,5,70942767,C,DEL,747,42,1,41,5.62
barcode12,5,70942768,T,DEL,756,12,1,11,1.59
barcode12,5,70942769,C,DEL,764,5,0,5,0.65
barcode12,5,70942770,C,DEL,783,4,0,4,0.51
barcode12,5,70942771,T,DEL,784,3,0,3,0.38
barcode12,5,70942772,G,DEL,787,9,1,8,1.14
barcode12,5,70942773,G,DEL,785,7,0,7,0.89
barcode12,5,70942774,A,DEL,781,19,0,19,2.43
barcode12,5,70942775,A,DEL,775,7,0,7,0.9
barcode12,5,70942776,A,DEL,770,3,0,3,0.39
barcode12,5,70942777,T,DEL,770,5,1,4,0.65
barcode12,5,70942778,A,DEL,771,6,0,6,0.78
barcode12,5,70942782,C,DEL,785,1,0,1,0.13
barcode12,5,70942783,A,DEL,781,1,0,1,0.13
barcode12,5,70942784,G,DEL,776,3,0,3,0.39
barcode12,5,70942785,A,DEL,669,3,0,3,0.45
barcode12,5,70942786,T,DEL,670,3,0,3,0.45
barcode12,5,70942787,A,DEL,620,2,0,2,0.32
barcode12,5,70942796,C,DEL,613,18,9,9,2.94
barcode12,5,70942799,A,DEL,565,2,0,2,0.35
barcode12,5,70942801,A,DEL,563,2,0,2,0.36
barcode12,5,70942802,T,DEL,560,19,0,19,3.39
barcode12,5,70942803,C,DEL,564,23,0,23,4.08
barcode12,5,70942804,T,DEL,573,2,1,1,0.35
barcode12,5,70942805,G,DEL,610,1,1,0,0.16
barcode12,5,70942806,C,DEL,609,3,0,3,0.49
barcode12,5,70942807,T,DEL,631,1,0,1,0.16
barcode12,5,70942808,C,DEL,632,7,3,4,1.11
barcode12,5,70942812,G,DEL,624,1,0,1,0.16
barcode12,5,70942813,G,DEL,624,1,0,1,0.16
barcode12,5,70942814,A,DEL,625,2,0,2,0.32
barcode12,5,70942815,A,DEL,621,1,1,0,0.16
barcode12,5,70942816,C,DEL,608,2,1,1,0.33
barcode12,5,70942817,T,DEL,608,2,1,1,0.33
barcode12,5,70942818,C,DEL,607,7,4,3,1.15
barcode12,5,70942819,T,DEL,607,56,14,42,9.23
barcode12,5,70942820,T,DEL,609,7,0,7,1.15
barcode12,5,70942821,T,DEL,599,15,1,14,2.5
barcode12,5,70942822,T,DEL,591,33,2,31,5.58
barcode12,5,70942823,C,DEL,591,44,2,42,7.45
barcode12,5,70942824,T,DEL,593,42,0,42,7.08
barcode12,5,70942825,C,DEL,598,102,19,83,17.06
barcode12,5,70942826,C,DEL,603,36,0,36,5.97
barcode12,5,70942827,C,DEL,601,18,0,18,3.0
barcode12,5,70942828,T,DEL,603,18,0,18,2.99
barcode12,5,70942829,C,DEL,597,33,3,30,5.53
barcode12,5,70942830,C,DEL,602,13,4,9,2.16
barcode12,5,70942831,A,DEL,603,5,4,1,0.83
barcode12,5,70942832,C,DEL,600,1,1,0,0.17
barcode12,5,70942833,C,DEL,600,3,1,2,0.5
barcode12,5,70942834,A,DEL,602,5,1,4,0.83
barcode12,5,70942835,C,DEL,602,163,126,37,27.08
barcode12,5,70942836,C,DEL,564,8,7,1,1.42
barcode12,5,70942837,C,DEL,563,5,5,0,0.89
barcode12,5,70942838,C,DEL,565,1,1,0,0.18
barcode12,5,70942839,C,DEL,563,1,0,1,0.18
barcode12,5,70942840,C,DEL,561,1,0,1,0.18
barcode12,5,70942841,A,DEL,561,2,1,1,0.36
barcode12,5,70942842,T,DEL,561,1,0,1,0.18
barcode12,5,70942843,G,DEL,562,1,0,1,0.18
barcode12,5,70942844,C,DEL,568,12,11,1,2.11
barcode12,5,70942845,C,DEL,567,1,1,0,0.18
barcode12,5,70942846,A,DEL,566,1,1,0,0.18
barcode12,5,70942847,G,DEL,565,3,3,0,0.53
barcode12,5,70942850,C,DEL,556,1,1,0,0.18
barcode12,5,70942852,A,DEL,553,41,13,28,7.41
barcode12,5,70942855,A,DEL,551,1,1,0,0.18
barcode12,5,70942856,C,DEL,553,2,1,1,0.36
barcode12,5,70942857,T,DEL,553,21,1,20,3.8
barcode12,5,70942858,G,DEL,553,27,2,25,4.88
barcode12,5,70942861,A,DEL,554,1,1,0,0.18
barcode12,5,70942864,A,DEL,552,2,0,2,0.36
barcode12,5,70942865,G,DEL,552,4,1,3,0.72
barcode12,5,70942866,G,DEL,547,2,0,2,0.37
barcode12,5,70942867,A,DEL,545,44,6,38,8.07
barcode12,5,70942868,A,DEL,544,4,0,4,0.74
barcode12,5,70942869,A,DEL,542,2,0,2,0.37
barcode12,5,70942870,G,DEL,541,2,0,2,0.37
barcode12,5,70942871,G,DEL,540,2,0,2,0.37
barcode12,5,70942872,T,DEL,540,3,0,3,0.56
barcode12,5,70942873,A,DEL,538,4,0,4,0.74
barcode12,5,70942874,A,DEL,538,3,0,3,0.56
barcode12,5,70942875,A,DEL,537,2,0,2,0.37
barcode12,5,70942876,C,DEL,535,2,0,2,0.37
barcode12,5,70942878,T,DEL,534,7,6,1,1.31
barcode12,5,70942879,T,DEL,535,1,1,0,0.19
barcode12,5,70942880,C,DEL,533,1,1,0,0.19
barcode12,5,70942881,T,DEL,532,6,0,6,1.13
barcode12,5,70942884,G,DEL,530,1,0,1,0.19
barcode12,5,70942885,A,DEL,529,27,0,27,5.1
barcode12,5,70942886,A,DEL,528,4,0,4,0.76
barcode12,5,70942888,G,DEL,523,2,1,1,0.38
barcode12,5,70942889,T,DEL,523,8,5,3,1.53
barcode12,5,70942893,C,DEL,518,6,2,4,1.16
barcode12,5,70942894,C,DEL,518,4,0,4,0.77
barcode12,5,70942895,A,DEL,513,22,15,7,4.29
barcode12,5,70942896,G,DEL,512,24,16,8,4.69
barcode12,5,70942897,A,DEL,494,16,1,15,3.24
barcode12,5,70942898,A,DEL,490,1,1,0,0.2
barcode12,5,70942899,A,DEL,486,1,1,0,0.21
barcode12,5,70942900,A,DEL,485,1,1,0,0.21
barcode12,5,70942901,T,DEL,484,2,2,0,0.41
barcode12,5,70942902,A,DEL,484,1,1,0,0.21
barcode12,5,70942904,T,DEL,482,7,7,0,1.45
barcode12,5,70942906,A,DEL,480,64,0,64,13.33
barcode12,5,70942908,T,DEL,477,2,2,0,0.42
barcode12,5,70942909,G,DEL,477,2,2,0,0.42
barcode12,5,70942911,C,DEL,471,14,12,2,2.97
barcode12,5,70942912,G,DEL,471,19,3,16,4.03
barcode12,5,70942914,G,DEL,460,1,0,1,0.22
barcode12,5,70942915,A,DEL,445,2,0,2,0.45
barcode12,5,70942918,T,DEL,443,21,14,7,4.74
barcode12,5,70942920,T,DEL,431,1,0,1,0.23
barcode12,5,70942921,A,DEL,430,7,0,7,1.63
barcode12,5,70942924,C,DEL,429,2,0,2,0.47
barcode12,5,70942925,T,DEL,429,2,0,2,0.47
barcode12,5,70942926,C,DEL,411,1,1,0,0.24
barcode12,5,70942927,T,DEL,411,1,0,1,0.24
barcode12,5,70942928,C,DEL,404,1,0,1,0.25
barcode12,5,70942929,T,DEL,404,4,0,4,0.99
barcode12,5,70942930,G,DEL,402,1,1,0,0.25
barcode12,5,70942931,T,DEL,399,4,4,0,1.0
barcode12,5,70942933,A,DEL,391,1,0,1,0.26
barcode12,5,70942939,T,DEL,353,11,11,0,3.12
barcode12,5,70942948,C,DEL,209,2,0,2,0.96
barcode12,5,70944618,A,DEL,722,4,0,4,0.55
barcode12,5,70944622,T,DEL,832,1,0,1,0.12
barcode12,5,70944623,G,DEL,837,1,0,1,0.12
barcode12,5,70944624,G,DEL,855,2,0,2,0.23
barcode12,5,70944625,T,DEL,862,6,0,6,0.7
barcode12,5,70944626,A,DEL,879,32,1,31,3.64
barcode12,5,70944628,G,DEL,893,6,1,5,0.67
barcode12,5,70944631,A,DEL,915,1,0,1,0.11
barcode12,5,70944633,T,DEL,921,31,3,28,3.37
barcode12,5,70944637,C,DEL,955,1,1,0,0.1
barcode12,5,70944639,T,DEL,957,14,9,5,1.46
barcode12,5,70944640,T,DEL,966,2,1,1,0.21
barcode12,5,70944641,T,DEL,966,1,0,1,0.1
barcode12,5,70944642,G,DEL,967,13,1,12,1.34
barcode12,5,70944643,A,DEL,973,6,0,6,0.62
barcode12,5,70944644,A,DEL,974,2,0,2,0.21
barcode12,5,70944648,T,DEL,996,10,6,4,1.0
barcode12,5,70944649,T,DEL,1005,16,0,16,1.59
barcode12,5,70944650,C,DEL,1011,17,0,17,1.68
barcode12,5,70944652,T,DEL,1020,12,1,11,1.18
barcode12,5,70944653,T,DEL,1024,9,0,9,0.88
barcode12,5,70944661,G,DEL,1112,2,2,0,0.18
barcode12,5,70944663,T,DEL,1121,2,0,2,0.18
barcode12,5,70944664,C,DEL,1120,3,1,2,0.27
barcode12,5,70944665,T,DEL,1125,10,0,10,0.89
barcode12,5,70944666,A,DEL,1128,23,1,22,2.04
barcode12,5,70944667,A,DEL,1132,6,0,6,0.53
barcode12,5,70944668,A,DEL,1134,8,0,8,0.71
barcode12,5,70944669,A,DEL,1134,8,1,7,0.71
barcode12,5,70944670,T,DEL,1141,12,1,11,1.05
barcode12,5,70944671,T,DEL,1147,4,2,2,0.35
barcode12,5,70944672,C,DEL,1149,6,2,4,0.52
barcode12,5,70944673,A,DEL,1154,6,2,4,0.52
barcode12,5,70944674,A,DEL,1159,2,2,0,0.17
barcode12,5,70944676,G,DEL,1163,3,3,0,0.26
barcode12,5,70944678,C,DEL,1181,27,2,25,2.29
barcode12,5,70944679,C,DEL,1189,4,1,3,0.34
barcode12,5,70944680,C,DEL,1199,6,3,3,0.5
barcode12,5,70944681,A,DEL,1206,17,14,3,1.41
barcode12,5,70944682,C,DEL,1206,2,1,1,0.17
barcode12,5,70944683,C,DEL,1209,2,1,1,0.17
barcode12,5,70944684,A,DEL,1213,2,1,1,0.16
barcode12,5,70944685,C,DEL,1216,3,1,2,0.25
barcode12,5,70944686,C,DEL,1217,3,1,2,0.25
barcode12,5,70944687,G,DEL,1228,6,1,5,0.49
barcode12,5,70944688,C,DEL,1234,2,0,2,0.16
barcode12,5,70944689,C,DEL,1242,2,0,2,0.16
barcode12,5,70944690,A,DEL,1250,2,1,1,0.16
barcode12,5,70944691,C,DEL,1251,3,3,0,0.24
barcode12,5,70944692,C,DEL,1249,1,1,0,0.08
barcode12,5,70944693,G,DEL,1258,3,1,2,0.24
barcode12,5,70944694,C,DEL,1266,22,4,18,1.74
barcode12,5,70944695,C,DEL,1269,20,3,17,1.58
barcode12,5,70944696,A,DEL,1280,20,3,17,1.56
barcode12,5,70944703,C,DEL,1324,6,4,2,0.45
barcode12,5,70944704,C,DEL,1311,4,1,3,0.31
barcode12,5,70944705,A,DEL,1319,6,1,5,0.45
barcode12,5,70944706,C,DEL,1317,115,105,10,8.73
barcode12,5,70944707,C,DEL,1317,9,1,8,0.68
barcode12,5,70944712,T,DEL,1326,6,5,1,0.45
barcode12,5,70944713,T,DEL,1311,1,1,0,0.08
barcode12,5,70944714,A,DEL,1318,30,30,0,2.28
barcode12,5,70944715,C,DEL,1317,3,3,0,0.23
barcode12,5,70944716,T,DEL,1312,2,0,2,0.15
barcode12,5,70944717,A,DEL,1309,3,0,3,0.23
barcode12,5,70944718,T,DEL,1310,3,0,3,0.23
barcode12,5,70944719,C,DEL,1299,2,0,2,0.15
barcode12,5,70944723,C,DEL,1286,13,2,11,1.01
barcode12,5,70944724,T,DEL,1290,15,0,15,1.16
barcode12,5,70944725,G,DEL,1286,1,0,1,0.08
barcode12,5,70944728,T,DEL,1280,2,0,2,0.16
barcode12,5,70944729,G,DEL,1281,5,3,2,0.39
barcode12,5,70944730,C,DEL,1268,12,0,12,0.95
barcode12,5,70944731,C,DEL,1263,1,0,1,0.08
barcode12,5,70944736,T,DEL,1270,15,4,11,1.18
barcode12,5,70944737,T,DEL,1269,1,0,1,0.08
barcode12,5,70944738,T,DEL,1272,1,0,1,0.08
barcode12,5,70944739,C,DEL,1274,2,0,2,0.16
barcode12,5,70944740,C,DEL,1274,1,0,1,0.08
barcode12,5,70944741,T,DEL,1273,32,5,27,2.51
barcode12,5,70944742,T,DEL,1287,9,2,7,0.7
barcode12,5,70944743,C,DEL,1286,13,2,11,1.01
barcode12,5,70944744,T,DEL,1288,14,0,14,1.09
barcode12,5,70944745,G,DEL,1286,3,2,1,0.23
barcode12,5,70944748,C,DEL,1256,2,2,0,0.16
barcode12,5,70944749,C,DEL,1258,1,1,0,0.08
barcode12,5,70944750,A,DEL,1280,1,1,0,0.08
barcode12,5,70944751,C,DEL,1279,4,4,0,0.31
barcode12,5,70944753,A,DEL,1279,12,2,10,0.94
barcode12,5,70944754,G,DEL,1279,10,0,10,0.78
barcode12,5,70944755,T,DEL,1274,16,0,16,1.26
barcode12,5,70944756,A,DEL,1250,15,0,15,1.2
barcode12,5,70944757,A,DEL,1250,13,0,13,1.04
barcode12,5,70944758,G,DEL,1245,16,0,16,1.29
barcode12,5,70944759,T,DEL,1248,39,0,39,3.12
barcode12,5,70944760,A,DEL,1233,276,15,261,22.38
barcode12,5,70944761,A,DEL,1231,132,4,128,10.72
barcode12,5,70944762,A,DEL,1230,118,1,117,9.59
barcode12,5,70944763,A,DEL,1225,36,0,36,2.94
barcode12,5,70944764,A,DEL,1226,3,0,3,0.24
barcode12,5,70944765,A,DEL,1224,4,0,4,0.33
barcode12,5,70944766,G,DEL,1222,8,3,5,0.65
barcode12,5,70944767,A,DEL,1219,2,0,2,0.16
barcode12,5,70944768,G,DEL,1219,2,0,2,0.16
barcode12,5,70944769,T,DEL,1220,51,0,51,4.18
barcode12,5,70944770,A,DEL,1208,4,0,4,0.33
barcode12,5,70944771,T,DEL,1209,6,0,6,0.5
barcode12,5,70944772,A,DEL,1206,2,2,0,0.17
barcode12,5,70944777,A,DEL,1191,6,1,5,0.5
barcode12,5,70944778,G,DEL,1188,17,11,6,1.43
barcode12,5,70944779,A,DEL,1180,1,0,1,0.08
barcode12,5,70944780,T,DEL,1180,46,11,35,3.9
barcode12,5,70944781,T,DEL,1171,1,1,0,0.09
barcode12,5,70944783,T,DEL,1167,1,1,0,0.09
barcode12,5,70944784,G,DEL,1165,1,1,0,0.09
barcode12,5,70944785,C,DEL,1160,1,1,0,0.09
barcode12,5,70944786,T,DEL,1160,10,3,7,0.86
barcode12,5,70944789,C,DEL,1130,7,5,2,0.62
barcode12,5,70944790,A,DEL,1127,6,2,4,0.53
barcode12,5,70944791,C,DEL,1125,1,0,1,0.09
barcode12,5,70944792,A,DEL,1093,1,1,0,0.09
barcode12,5,70944793,T,DEL,1090,2,1,1,0.18
barcode12,5,70944794,A,DEL,1077,2,2,0,0.19
barcode12,5,70944798,T,DEL,1044,11,4,7,1.05
barcode12,5,70944800,T,DEL,1031,1,0,1,0.1
barcode12,5,70944801,G,DEL,1021,1,0,1,0.1
barcode12,5,70944802,A,DEL,972,4,0,4,0.41
barcode12,5,70944803,T,DEL,967,3,0,3,0.31
barcode12,5,70944806,T,DEL,949,3,3,0,0.32
barcode12,5,70944809,G,DEL,935,2,1,1,0.21
barcode12,5,70944812,G,DEL,900,1,0,1,0.11
barcode12,5,70944813,A,DEL,877,6,5,1,0.68
barcode12,5,70944816,A,DEL,806,6,6,0,0.74
barcode12,5,70944817,G,DEL,791,9,9,0,1.14
barcode12,5,70944819,G,DEL,761,15,15,0,1.97
barcode12,5,70944820,G,DEL,745,5,5,0,0.67
barcode12,5,70944821,A,DEL,738,5,5,0,0.68
barcode12,5,70944822,T,DEL,738,2,2,0,0.27
barcode12,5,70944825,T,DEL,707,3,0,3,0.42
barcode12,5,70944826,A,DEL,682,38,31,7,5.57
barcode12,5,70945984,C,DEL,1102,17,0,17,1.54
barcode12,5,70945987,G,DEL,1196,4,0,4,0.33
barcode12,5,70945990,T,DEL,1246,9,9,0,0.72
barcode12,5,70945994,C,DEL,1315,3,3,0,0.23
barcode12,5,70945995,T,DEL,1316,12,6,6,0.91
barcode12,5,70945996,A,DEL,1329,12,6,6,0.9
barcode12,5,70945997,T,DEL,1335,1,0,1,0.07
barcode12,5,70945998,A,DEL,1368,1,0,1,0.07
barcode12,5,70945999,T,DEL,1371,1,0,1,0.07
barcode12,5,70946000,A,DEL,1380,16,0,16,1.16
barcode12,5,70946001,A,DEL,1382,2,1,1,0.14
barcode12,5,70946002,T,DEL,1383,10,1,9,0.72
barcode12,5,70946003,A,DEL,1408,1,0,1,0.07
barcode12,5,70946004,T,DEL,1413,2,0,2,0.14
barcode12,5,70946005,A,DEL,1417,27,1,26,1.91
barcode12,5,70946006,A,DEL,1421,9,0,9,0.63
barcode12,5,70946007,A,DEL,1430,1,0,1,0.07
barcode12,5,70946008,T,DEL,1430,2,1,1,0.14
barcode12,5,70946009,C,DEL,1442,4,2,2,0.28
barcode12,5,70946010,T,DEL,1461,1,0,1,0.07
barcode12,5,70946011,C,DEL,1472,5,3,2,0.34
barcode12,5,70946012,C,DEL,1476,17,2,15,1.15
barcode12,5,70946013,A,DEL,1478,39,1,38,2.64
barcode12,5,70946014,G,DEL,1483,47,9,38,3.17
barcode12,5,70946015,A,DEL,1500,2,2,0,0.13
barcode12,5,70946016,C,DEL,1501,4,2,2,0.27
barcode12,5,70946017,T,DEL,1515,14,14,0,0.92
barcode12,5,70946018,T,DEL,1520,4,3,1,0.26
barcode12,5,70946019,T,DEL,1520,5,4,1,0.33
barcode12,5,70946020,A,DEL,1539,7,6,1,0.45
barcode12,5,70946021,C,DEL,1544,1,1,0,0.06
barcode12,5,70946022,T,DEL,1547,119,33,86,7.69
barcode12,5,70946023,T,DEL,1556,5,3,2,0.32
barcode12,5,70946024,T,DEL,1560,5,3,2,0.32
barcode12,5,70946025,T,DEL,1569,2,1,1,0.13
barcode12,5,70946026,T,DEL,1574,1,0,1,0.06
barcode12,5,70946027,T,DEL,1577,2,1,1,0.13
barcode12,5,70946028,G,DEL,1626,4,3,1,0.25
barcode12,5,70946029,T,DEL,1643,9,4,5,0.55
barcode12,5,70946032,A,DEL,1748,17,17,0,0.97
barcode12,5,70946033,C,DEL,1750,41,2,39,2.34
barcode12,5,70946035,G,DEL,1771,3,0,3,0.17
barcode12,5,70946036,G,DEL,1772,2,0,2,0.11
barcode12,5,70946037,A,DEL,1785,10,0,10,0.56
barcode12,5,70946038,T,DEL,1786,11,1,10,0.62
barcode12,5,70946039,A,DEL,1793,1,0,1,0.06
barcode12,5,70946040,T,DEL,1793,1,0,1,0.06
barcode12,5,70946041,A,DEL,1807,99,1,98,5.48
barcode12,5,70946042,A,DEL,1811,2,1,1,0.11
barcode12,5,70946043,A,DEL,1811,2,1,1,0.11
barcode12,5,70946044,C,DEL,1815,3,1,2,0.17
barcode12,5,70946045,A,DEL,1816,16,1,15,0.88
barcode12,5,70946046,A,DEL,1819,15,13,2,0.82
barcode12,5,70946047,T,DEL,1820,18,16,2,0.99
barcode12,5,70946048,A,DEL,1866,5,1,4,0.27
barcode12,5,70946049,T,DEL,1867,3,1,2,0.16
barcode12,5,70946050,C,DEL,1871,10,4,6,0.53
barcode12,5,70946051,T,DEL,1875,260,201,59,13.87
barcode12,5,70946052,T,DEL,1882,63,55,8,3.35
barcode12,5,70946053,T,DEL,1884,27,26,1,1.43
barcode12,5,70946054,T,DEL,1896,14,13,1,0.74
barcode12,5,70946055,T,DEL,1898,22,18,4,1.16
barcode12,5,70946056,C,DEL,1901,27,21,6,1.42
barcode12,5,70946057,T,DEL,1903,24,6,18,1.26
barcode12,5,70946058,G,DEL,1906,9,6,3,0.47
barcode12,5,70946059,T,DEL,1911,2,2,0,0.1
barcode12,5,70946060,C,DEL,1911,60,1,59,3.14
barcode12,5,70946061,T,DEL,1934,3,2,1,0.16
barcode12,5,70946062,C,DEL,1937,15,14,1,0.77
barcode12,5,70946063,C,DEL,1952,5,1,4,0.26
barcode12,5,70946064,A,DEL,1954,7,2,5,0.36
barcode12,5,70946065,G,DEL,1953,17,5,12,0.87
barcode12,5,70946066,A,DEL,1950,95,0,95,4.87
barcode12,5,70946067,T,DEL,1951,101,0,101,5.18
barcode12,5,70946068,A,DEL,1958,4,1,3,0.2
barcode12,5,70946069,A,DEL,1960,3,1,2,0.15
barcode12,5,70946070,T,DEL,1972,9,0,9,0.46
barcode12,5,70946071,T,DEL,1978,7,0,7,0.35
barcode12,5,70946072,C,DEL,1986,368,81,287,18.53
barcode12,5,70946073,C,DEL,2002,49,15,34,2.45
barcode12,5,70946074,C,DEL,2011,14,6,8,0.7
barcode12,5,70946075,C,DEL,2015,12,4,8,0.6
barcode12,5,70946076,C,DEL,2008,12,4,8,0.6
barcode12,5,70946077,A,DEL,2012,10,4,6,0.5
barcode12,5,70946078,C,DEL,2012,6,2,4,0.3
barcode12,5,70946079,C,DEL,2006,1,1,0,0.05
barcode12,5,70946080,A,DEL,2014,1,1,0,0.05
barcode12,5,70946081,C,DEL,2016,9,2,7,0.45
barcode12,5,70946082,C,DEL,2015,4,1,3,0.2
barcode12,5,70946083,T,DEL,2015,8,4,4,0.4
barcode12,5,70946084,C,DEL,2019,288,286,2,14.26
barcode12,5,70946087,A,DEL,2008,38,2,36,1.89
barcode12,5,70946088,T,DEL,2006,38,1,37,1.89
barcode12,5,70946089,A,DEL,1986,2,0,2,0.1
barcode12,5,70946090,T,DEL,1986,10,8,2,0.5
barcode12,5,70946091,G,DEL,1987,12,9,3,0.6
barcode12,5,70946092,T,DEL,1994,2,1,1,0.1
barcode12,5,70946093,C,DEL,1989,18,17,1,0.9
barcode12,5,70946095,A,DEL,1991,2,2,0,0.1
barcode12,5,70946096,G,DEL,1991,16,3,13,0.8
barcode12,5,70946097,A,DEL,1992,5,5,0,0.25
barcode12,5,70946098,T,DEL,2001,13,3,10,0.65
barcode12,5,70946099,T,DEL,1997,322,10,312,16.12
barcode12,5,70946100,C,DEL,1996,334,18,316,16.73
barcode12,5,70946101,T,DEL,2009,6,0,6,0.3
barcode12,5,70946102,C,DEL,1999,13,1,12,0.65
barcode12,5,70946103,T,DEL,2013,64,22,42,3.18
barcode12,5,70946104,T,DEL,2014,54,1,53,2.68
barcode12,5,70946105,G,DEL,2014,72,1,71,3.57
barcode12,5,70946106,A,DEL,2034,4,1,3,0.2
barcode12,5,70946107,T,DEL,2033,1,0,1,0.05
barcode12,5,70946108,G,DEL,2029,2,0,2,0.1
barcode12,5,70946110,T,DEL,2022,2,2,0,0.1
barcode12,5,70946111,G,DEL,2027,2,2,0,0.1
barcode12,5,70946112,C,DEL,2037,2,2,0,0.1
barcode12,5,70946113,T,DEL,2036,2,0,2,0.1
barcode12,5,70946114,G,DEL,2039,9,1,8,0.44
barcode12,5,70946115,A,DEL,2049,1,1,0,0.05
barcode12,5,70946116,T,DEL,2046,1,0,1,0.05
barcode12,5,70946117,G,DEL,2052,2,1,1,0.1
barcode12,5,70946118,C,DEL,2038,23,1,22,1.13
barcode12,5,70946119,T,DEL,2045,17,12,5,0.83
barcode12,5,70946120,T,DEL,2067,6,5,1,0.29
barcode12,5,70946121,T,DEL,2080,2,0,2,0.1
barcode12,5,70946122,G,DEL,2093,172,8,164,8.22
barcode12,5,70946124,G,DEL,2103,10,0,10,0.48
barcode12,5,70946125,A,DEL,2093,47,2,45,2.25
barcode12,5,70946126,A,DEL,2087,1,0,1,0.05
barcode12,5,70946127,G,DEL,2078,24,15,9,1.15
barcode12,5,70946128,T,DEL,2072,55,1,54,2.65
barcode12,5,70946129,A,DEL,2106,1,1,0,0.05
barcode12,5,70946130,T,DEL,2106,3,3,0,0.14
barcode12,5,70946131,G,DEL,2110,6,6,0,0.28
barcode12,5,70946132,T,DEL,2117,239,239,0,11.29
barcode12,5,70946134,A,DEL,2109,11,2,9,0.52
barcode12,5,70946135,A,DEL,2114,1,0,1,0.05
barcode12,5,70946136,T,DEL,2129,22,8,14,1.03
barcode12,5,70946138,T,DEL,2173,1,1,0,0.05
barcode12,5,70946139,C,DEL,2182,1,1,0,0.05
barcode12,5,70946140,A,DEL,2201,2,2,0,0.09
barcode12,5,70946143,G,DEL,2158,5,0,5,0.23
barcode12,5,70946144,T,DEL,2163,13,0,13,0.6
barcode12,5,70946145,A,DEL,2149,1,0,1,0.05
barcode12,5,70946146,C,DEL,2157,1,0,1,0.05
barcode12,5,70946148,T,DEL,2160,1,1,0,0.05
barcode12,5,70946149,G,DEL,2164,1,1,0,0.05
barcode12,5,70946150,A,DEL,2203,5,5,0,0.23
barcode12,5,70946151,G,DEL,2195,8,7,1,0.36
barcode12,5,70946152,T,DEL,2205,2,1,1,0.09
barcode12,5,70946154,G,DEL,2221,1,1,0,0.05
barcode12,5,70946155,C,DEL,2214,3,2,1,0.14
barcode12,5,70946156,T,DEL,2214,3,2,1,0.14
barcode12,5,70946157,A,DEL,2193,4,3,1,0.18
barcode12,5,70946158,T,DEL,2191,1,1,0,0.05
barcode12,5,70946161,T,DEL,2138,2,2,0,0.09
barcode12,5,70946162,A,DEL,2305,2,1,1,0.09
barcode12,5,70946163,C,DEL,2304,11,1,10,0.48
barcode12,5,70946164,T,DEL,2320,6,0,6,0.26
barcode12,5,70946165,G,DEL,2332,1,0,1,0.04
barcode12,5,70946166,G,DEL,2341,1,0,1,0.04
barcode12,5,70946167,C,DEL,2317,1,0,1,0.04
barcode12,5,70946168,T,DEL,2317,8,8,0,0.35
barcode12,5,70946169,A,DEL,2280,9,9,0,0.39
barcode12,5,70946170,T,DEL,2275,18,18,0,0.79
barcode12,5,70946171,T,DEL,2271,50,50,0,2.2
barcode12,5,70946172,A,DEL,2282,51,51,0,2.23
barcode12,5,70946173,T,DEL,2274,10,10,0,0.44
barcode12,5,70946174,A,DEL,2337,11,11,0,0.47
barcode12,5,70946176,G,DEL,2339,1,1,0,0.04
barcode12,5,70946177,G,DEL,2381,36,0,36,1.51
barcode12,5,70946178,T,DEL,2383,45,1,44,1.89
barcode12,5,70946179,A,DEL,2346,15,4,11,0.64
barcode12,5,70946180,A,DEL,2355,11,0,11,0.47
barcode12,5,70946181,G,DEL,2347,13,0,13,0.55
barcode12,5,70946182,T,DEL,2350,11,0,11,0.47
barcode12,5,70946183,A,DEL,2318,53,0,53,2.29
barcode12,5,70946188,C,DEL,2340,1,1,0,0.04
barcode12,5,70946189,T,DEL,2391,5,1,4,0.21
barcode12,5,70946190,C,DEL,2400,83,1,82,3.46
barcode12,5,70946191,A,DEL,2409,1,1,0,0.04
barcode12,5,70946192,G,DEL,2411,5,3,2,0.21
barcode12,5,70946194,A,DEL,2420,1,0,1,0.04
barcode12,5,70946195,T,DEL,2421,5,4,1,0.21
barcode12,5,70946196,C,DEL,2429,9,5,4,0.37
barcode12,5,70946197,T,DEL,2436,579,521,58,23.77
barcode12,5,70946198,T,DEL,2442,36,36,0,1.47
barcode12,5,70946199,T,DEL,2446,5,5,0,0.2
barcode12,5,70946200,T,DEL,2439,4,3,1,0.16
barcode12,5,70946201,C,DEL,2441,10,4,6,0.41
barcode12,5,70946202,C,DEL,2448,5,4,1,0.2
barcode12,5,70946203,T,DEL,2446,1,0,1,0.04
barcode12,5,70946204,G,DEL,2446,44,0,44,1.8
barcode12,5,70946205,A,DEL,2443,4,1,3,0.16
barcode12,5,70946206,C,DEL,2441,3,0,3,0.12
barcode12,5,70946209,T,DEL,2435,115,97,18,4.72
barcode12,5,70946210,T,DEL,2445,6,3,3,0.25
barcode12,5,70946211,T,DEL,2445,2,0,2,0.08
barcode12,5,70946215,T,DEL,2474,2,0,2,0.08
barcode12,5,70946216,G,DEL,2504,3,1,2,0.12
barcode12,5,70946217,T,DEL,2510,3,1,2,0.12
barcode12,5,70946218,A,DEL,2531,1,1,0,0.04
barcode12,5,70946221,T,DEL,2531,2,2,0,0.08
barcode12,5,70946222,A,DEL,2534,3,3,0,0.12
barcode12,5,70946223,T,DEL,2533,1,0,1,0.04
barcode12,5,70946224,G,DEL,2551,1,0,1,0.04
barcode12,5,70946225,T,DEL,2548,4,4,0,0.16
barcode12,5,70946228,C,DEL,2545,3,1,2,0.12
barcode12,5,70946229,T,DEL,2548,49,49,0,1.92
barcode12,5,70946230,T,DEL,2522,2,2,0,0.08
barcode12,5,70946231,T,DEL,2511,3,3,0,0.12
barcode12,5,70946232,G,DEL,2505,4,4,0,0.16
barcode12,5,70946233,T,DEL,2504,70,50,20,2.8
barcode12,5,70946234,T,DEL,2502,1,1,0,0.04
barcode12,5,70946235,T,DEL,2496,1,1,0,0.04
barcode12,5,70946236,T,DEL,2497,5,5,0,0.2
barcode12,5,70946237,G,DEL,2499,7,6,1,0.28
barcode12,5,70946238,T,DEL,2500,7,0,7,0.28
barcode12,5,70946239,A,DEL,2467,31,29,2,1.26
barcode12,5,70946241,A,DEL,2468,6,6,0,0.24
barcode12,5,70946242,T,DEL,2466,59,16,43,2.39
barcode12,5,70946243,T,DEL,2456,6,5,1,0.24
barcode12,5,70946244,T,DEL,2449,12,11,1,0.49
barcode12,5,70946245,A,DEL,2423,31,30,1,1.28
barcode12,5,70946246,T,DEL,2417,4,2,2,0.17
barcode12,5,70946247,A,DEL,2397,75,40,35,3.13
barcode12,5,70946248,A,DEL,2395,4,2,2,0.17
barcode12,5,70946249,A,DEL,2390,3,2,1,0.13
barcode12,5,70946250,A,DEL,2378,3,3,0,0.13
barcode12,5,70946251,T,DEL,2374,3,3,0,0.13
barcode12,5,70946252,A,DEL,2368,5,3,2,0.21
barcode12,5,70946253,C,DEL,2367,12,9,3,0.51
barcode12,5,70946254,T,DEL,2367,1,0,1,0.04
barcode12,5,70946255,A,DEL,2365,6,6,0,0.25
barcode12,5,70946256,C,DEL,2361,2,2,0,0.08
barcode12,5,70946257,T,DEL,2357,11,8,3,0.47
barcode12,5,70946259,G,DEL,2344,1,1,0,0.04
barcode12,5,70946260,C,DEL,2328,6,5,1,0.26
barcode12,5,70946261,T,DEL,2328,29,26,3,1.25
barcode12,5,70946262,T,DEL,2307,36,33,3,1.56
barcode12,5,70946263,C,DEL,2300,42,37,5,1.83
barcode12,5,70946264,T,DEL,2299,1,0,1,0.04
barcode12,5,70946265,C,DEL,2279,11,9,2,0.48
barcode12,5,70946266,T,DEL,2269,18,11,7,0.79
barcode12,5,70946267,C,DEL,2244,25,16,9,1.11
barcode12,5,70946268,T,DEL,2230,198,191,7,8.88
barcode12,5,70946269,T,DEL,2215,10,3,7,0.45
barcode12,5,70946270,T,DEL,2207,14,5,9,0.63
barcode12,5,70946271,A,DEL,2187,12,10,2,0.55
barcode12,5,70946272,T,DEL,2184,5,5,0,0.23
barcode12,5,70946273,A,DEL,2158,9,9,0,0.42
barcode12,5,70946274,T,DEL,2154,17,17,0,0.79
barcode12,5,70946275,T,DEL,2150,12,12,0,0.56
barcode12,5,70946276,A,DEL,2132,42,42,0,1.97
barcode12,5,70946277,C,DEL,2125,14,14,0,0.66
barcode12,5,70946278,T,DEL,2123,1,1,0,0.05
barcode12,5,70946279,A,DEL,2083,32,25,7,1.54
barcode12,5,70946285,T,DEL,2022,1,1,0,0.05
barcode12,5,70946286,A,DEL,1997,68,66,2,3.41
barcode12,5,70946288,A,DEL,1994,1,1,0,0.05
barcode12,5,70946289,A,DEL,1989,1,1,0,0.05
barcode12,5,70946290,A,DEL,1974,1,1,0,0.05
barcode12,5,70946291,T,DEL,1967,1,1,0,0.05
barcode12,5,70946292,A,DEL,1935,267,257,10,13.8
barcode12,5,70946293,A,DEL,1934,86,86,0,4.45
barcode12,5,70946294,A,DEL,1919,26,26,0,1.35
barcode12,5,70946301,C,DEL,1809,3,3,0,0.17
barcode12,5,70946302,A,DEL,1776,1,1,0,0.06
barcode12,5,70946305,T,DEL,1739,5,5,0,0.29
barcode12,5,70946306,G,DEL,1712,5,5,0,0.29
barcode12,5,70946307,T,DEL,1698,7,7,0,0.41
barcode12,5,70946308,C,DEL,1514,8,8,0,0.53
barcode12,5,70946310,G,DEL,1433,1,1,0,0.07
barcode12,5,70946311,A,DEL,1408,1,1,0,0.07
barcode12,5,70946315,T,DEL,1135,7,7,0,0.62
barcode12,5,70946317,A,DEL,117,1,0,1,0.85
barcode12,5,70951943,T,DEL,1241,27,1,26,2.18
barcode12,5,70951946,C,DEL,1286,2,0,2,0.16
barcode12,5,70951947,A,DEL,1290,5,0,5,0.39
barcode12,5,70951948,G,DEL,1294,20,2,18,1.55
barcode12,5,70951949,A,DEL,1304,9,1,8,0.69
barcode12,5,70951950,C,DEL,1304,7,0,7,0.54
barcode12,5,70951951,A,DEL,1307,192,4,188,14.69
barcode12,5,70951957,A,DEL,1332,200,25,175,15.02
barcode12,5,70951958,A,DEL,1345,22,2,20,1.64
barcode12,5,70951959,A,DEL,1350,1,0,1,0.07
barcode12,5,70951961,A,DEL,1360,2,2,0,0.15
barcode12,5,70951962,G,DEL,1360,10,6,4,0.74
barcode12,5,70951963,A,DEL,1377,80,4,76,5.81
barcode12,5,70951964,A,DEL,1381,4,3,1,0.29
barcode12,5,70951965,G,DEL,1381,6,3,3,0.43
barcode12,5,70951966,G,DEL,1387,2,0,2,0.14
barcode12,5,70951967,A,DEL,1400,90,2,88,6.43
barcode12,5,70951969,G,DEL,1406,2,2,0,0.14
barcode12,5,70951970,G,DEL,1415,1,1,0,0.07
barcode12,5,70951972,G,DEL,1428,1,1,0,0.07
barcode12,5,70951973,C,DEL,1440,29,1,28,2.01
barcode12,5,70951975,C,DEL,1458,18,1,17,1.23
barcode12,5,70951976,A,DEL,1463,11,0,11,0.75
barcode12,5,70951977,C,DEL,1473,2,2,0,0.14
barcode12,5,70951978,A,DEL,1476,5,0,5,0.34
barcode12,5,70951979,T,DEL,1486,7,5,2,0.47
barcode12,5,70951980,T,DEL,1488,5,0,5,0.34
barcode12,5,70951981,C,DEL,1495,8,0,8,0.54
barcode12,5,70951982,C,DEL,1506,1,0,1,0.07
barcode12,5,70951983,T,DEL,1515,26,13,13,1.72
barcode12,5,70951984,T,DEL,1519,13,2,11,0.86
barcode12,5,70951985,A,DEL,1523,18,12,6,1.18
barcode12,5,70951986,A,DEL,1526,1,1,0,0.07
barcode12,5,70951987,A,DEL,1534,1,1,0,0.07
barcode12,5,70951990,A,DEL,1556,29,0,29,1.86
barcode12,5,70951992,G,DEL,1566,3,2,1,0.19
barcode12,5,70951993,G,DEL,1571,6,6,0,0.38
barcode12,5,70951994,A,DEL,1584,6,6,0,0.38
barcode12,5,70951995,G,DEL,1584,17,6,11,1.07
barcode12,5,70951996,T,DEL,1587,12,1,11,0.76
barcode12,5,70951997,A,DEL,1598,3,1,2,0.19
barcode12,5,70951998,A,DEL,1609,1,0,1,0.06
barcode12,5,70952000,T,DEL,1628,3,3,0,0.18
barcode12,5,70952001,C,DEL,1636,20,5,15,1.22
barcode12,5,70952002,T,DEL,1652,13,0,13,0.79
barcode12,5,70952003,G,DEL,1749,6,0,6,0.34
barcode12,5,70952004,C,DEL,1806,19,13,6,1.05
barcode12,5,70952005,C,DEL,1803,6,0,6,0.33
barcode12,5,70952006,A,DEL,1823,3,3,0,0.16
barcode12,5,70952007,G,DEL,1834,5,1,4,0.27
barcode12,5,70952010,T,DEL,1831,5,5,0,0.27
barcode12,5,70952011,T,DEL,1830,4,4,0,0.22
barcode12,5,70952012,A,DEL,1852,5,5,0,0.27
barcode12,5,70952014,G,DEL,1859,5,0,5,0.27
barcode12,5,70952015,A,DEL,1871,250,49,201,13.36
barcode12,5,70952016,A,DEL,1880,1,0,1,0.05
barcode12,5,70952017,A,DEL,1881,1,1,0,0.05
barcode12,5,70952018,G,DEL,1881,1,1,0,0.05
barcode12,5,70952020,G,DEL,1884,6,0,6,0.32
barcode12,5,70952021,A,DEL,1894,3,0,3,0.16
barcode12,5,70952023,T,DEL,1898,5,4,1,0.26
barcode12,5,70952024,C,DEL,1903,4,4,0,0.21
barcode12,5,70952025,T,DEL,1904,13,11,2,0.68
barcode12,5,70952026,T,DEL,1905,3,1,2,0.16
barcode12,5,70952027,A,DEL,1928,6,4,2,0.31
barcode12,5,70952028,C,DEL,1929,5,3,2,0.26
barcode12,5,70952029,T,DEL,1933,153,20,133,7.92
barcode12,5,70952030,T,DEL,1934,1,1,0,0.05
barcode12,5,70952031,T,DEL,1933,6,6,0,0.31
barcode12,5,70952032,T,DEL,1929,10,10,0,0.52
barcode12,5,70952033,G,DEL,1944,13,13,0,0.67
barcode12,5,70952034,T,DEL,1946,41,1,40,2.11
barcode12,5,70952035,A,DEL,1933,12,6,6,0.62
barcode12,5,70952040,T,DEL,1933,10,6,4,0.52
barcode12,5,70952041,T,DEL,1932,2,0,2,0.1
barcode12,5,70952042,T,DEL,1930,2,0,2,0.1
barcode12,5,70952043,A,DEL,1946,3,1,2,0.15
barcode12,5,70952044,T,DEL,1952,4,0,4,0.2
barcode12,5,70952045,G,DEL,1948,3,1,2,0.15
barcode12,5,70952046,G,DEL,1951,1,0,1,0.05
barcode12,5,70952047,T,DEL,1966,9,2,7,0.46
barcode12,5,70952048,T,DEL,1974,1,0,1,0.05
barcode12,5,70952049,T,DEL,1985,2,0,2,0.1
barcode12,5,70952050,G,DEL,2077,3,1,2,0.14
barcode12,5,70952051,T,DEL,2093,1,0,1,0.05
barcode12,5,70952052,G,DEL,2097,23,22,1,1.1
barcode12,5,70952053,G,DEL,2094,1,0,1,0.05
barcode12,5,70952054,A,DEL,2094,17,2,15,0.81
barcode12,5,70952055,A,DEL,2062,2,0,2,0.1
barcode12,5,70952056,A,DEL,2051,1,0,1,0.05
barcode12,5,70952057,A,DEL,2049,1,0,1,0.05
barcode12,5,70952058,C,DEL,2049,3,0,3,0.15
barcode12,5,70952059,A,DEL,2050,107,0,107,5.22
barcode12,5,70952061,A,DEL,2052,1,0,1,0.05
barcode12,5,70952062,T,DEL,2052,9,6,3,0.44
barcode12,5,70952063,G,DEL,2050,10,6,4,0.49
barcode12,5,70952064,T,DEL,2048,91,25,66,4.44
barcode12,5,70952065,T,DEL,2048,7,1,6,0.34
barcode12,5,70952066,T,DEL,2049,1,1,0,0.05
barcode12,5,70952067,T,DEL,2065,1,1,0,0.05
barcode12,5,70952069,G,DEL,2064,13,0,13,0.63
barcode12,5,70952070,A,DEL,2080,17,0,17,0.82
barcode12,5,70952071,A,DEL,2083,4,3,1,0.19
barcode12,5,70952072,C,DEL,2080,12,11,1,0.58
barcode12,5,70952073,A,DEL,2084,1,0,1,0.05
barcode12,5,70952074,T,DEL,2086,20,13,7,0.96
barcode12,5,70952075,T,DEL,2090,3,3,0,0.14
barcode12,5,70952076,T,DEL,2085,2,1,1,0.1
barcode12,5,70952077,A,DEL,2102,166,8,158,7.9
barcode12,5,70952078,A,DEL,2109,34,1,33,1.61
barcode12,5,70952079,A,DEL,2109,2,1,1,0.09
barcode12,5,70952080,A,DEL,2106,2,1,1,0.09
barcode12,5,70952081,A,DEL,2103,4,1,3,0.19
barcode12,5,70952082,G,DEL,2103,6,1,5,0.29
barcode12,5,70952083,T,DEL,2119,59,59,0,2.78
barcode12,5,70952084,T,DEL,2128,13,13,0,0.61
barcode12,5,70952085,C,DEL,2125,55,43,12,2.59
barcode12,5,70952086,A,DEL,2129,63,4,59,2.96
barcode12,5,70952087,G,DEL,2128,73,6,67,3.43
barcode12,5,70952088,A,DEL,2122,2,2,0,0.09
barcode12,5,70952089,T,DEL,2122,1,1,0,0.05
barcode12,5,70952090,G,DEL,2150,1,1,0,0.05
barcode12,5,70952091,T,DEL,2154,35,35,0,1.62
barcode12,5,70952092,T,DEL,2194,1,0,1,0.05
barcode12,5,70952093,A,DEL,2213,66,2,64,2.98
barcode12,5,70952094,A,DEL,2205,8,0,8,0.36
barcode12,5,70952095,A,DEL,2211,1,0,1,0.05
barcode12,5,70952097,A,DEL,2201,6,0,6,0.27
barcode12,5,70952098,G,DEL,2191,7,1,6,0.32
barcode12,5,70952099,T,DEL,2192,20,14,6,0.91
barcode12,5,70952102,A,DEL,2268,102,0,102,4.5
barcode12,5,70952106,G,DEL,2278,1,1,0,0.04
barcode12,5,70952107,T,DEL,2290,9,9,0,0.39
barcode12,5,70952108,T,DEL,2286,2,2,0,0.09
barcode12,5,70952109,A,DEL,2285,7,2,5,0.31
barcode12,5,70952110,A,DEL,2285,2,2,0,0.09
barcode12,5,70952111,T,DEL,2279,3,2,1,0.13
barcode12,5,70952112,G,DEL,2278,1,1,0,0.04
barcode12,5,70952113,T,DEL,2265,44,1,43,1.94
barcode12,5,70952114,A,DEL,2252,15,2,13,0.67
barcode12,5,70952123,A,DEL,2123,4,0,4,0.19
barcode12,5,70952124,A,DEL,2123,2,0,2,0.09
barcode12,5,70952125,T,DEL,2123,1,0,1,0.05
barcode12,5,70952126,A,DEL,2099,5,3,2,0.24
barcode12,5,70952127,T,DEL,2098,32,31,1,1.53
barcode12,5,70952129,A,DEL,2096,20,3,17,0.95
barcode12,5,70952131,A,DEL,2092,1,1,0,0.05
barcode12,5,70952132,G,DEL,2079,9,9,0,0.43
barcode12,5,70952133,A,DEL,2073,3,3,0,0.14
barcode12,5,70952135,T,DEL,2059,205,134,71,9.96
barcode12,5,70952136,T,DEL,2056,1,1,0,0.05
barcode12,5,70952137,T,DEL,2055,1,0,1,0.05
barcode12,5,70952138,T,DEL,2049,1,0,1,0.05
barcode12,5,70952139,G,DEL,2046,2,0,2,0.1
barcode12,5,70952140,A,DEL,2048,2,0,2,0.1
barcode12,5,70952143,C,DEL,2040,54,50,4,2.65
barcode12,5,70952144,C,DEL,2030,3,1,2,0.15
barcode12,5,70952145,A,DEL,2014,21,8,13,1.04
barcode12,5,70952150,T,DEL,1991,1,1,0,0.05
barcode12,5,70952151,A,DEL,1979,1,1,0,0.05
barcode12,5,70952152,T,DEL,1977,16,15,1,0.81
barcode12,5,70952153,T,DEL,1971,2,2,0,0.1
barcode12,5,70952154,A,DEL,1938,4,3,1,0.21
barcode12,5,70952155,G,DEL,1933,7,5,2,0.36
barcode12,5,70952158,A,DEL,1911,70,43,27,3.66
barcode12,5,70952159,A,DEL,1908,3,0,3,0.16
barcode12,5,70952164,T,DEL,1888,11,11,0,0.58
barcode12,5,70952165,T,DEL,1878,2,2,0,0.11
barcode12,5,70952166,A,DEL,1852,3,1,2,0.16
barcode12,5,70952168,T,DEL,1836,1,0,1,0.05
barcode12,5,70952169,C,DEL,1801,4,0,4,0.22
barcode12,5,70952170,T,DEL,1799,12,0,12,0.67
barcode12,5,70952171,A,DEL,1773,3,0,3,0.17
barcode12,5,70952172,C,DEL,1750,1,0,1,0.06
barcode12,5,70952173,A,DEL,1728,2,0,2,0.12
barcode12,5,70952174,T,DEL,1727,6,0,6,0.35
barcode12,5,70952175,C,DEL,1712,28,23,5,1.64
barcode12,5,70952177,C,DEL,1704,1,0,1,0.06
barcode12,5,70952178,T,DEL,1674,15,1,14,0.9
barcode12,5,70952179,A,DEL,1627,16,16,0,0.98
barcode12,5,70952180,C,DEL,1603,1,1,0,0.06
barcode12,5,70952182,A,DEL,1554,7,7,0,0.45
barcode12,5,70952183,G,DEL,1548,6,4,2,0.39
barcode12,5,70952184,A,DEL,1536,3,0,3,0.2
barcode12,5,70952188,C,DEL,1504,1,1,0,0.07
barcode12,5,70952189,T,DEL,1486,3,0,3,0.2
barcode12,5,70952190,C,DEL,1477,6,0,6,0.41
barcode12,5,70952192,T,DEL,1463,1,1,0,0.07
barcode12,5,70952193,A,DEL,1433,2,2,0,0.14
barcode12,5,70952194,C,DEL,1298,1,1,0,0.08
barcode12,5,70952195,T,DEL,1277,5,5,0,0.39
barcode12,5,70952199,C,DEL,1112,1,0,1,0.09
barcode12,5,70952200,T,DEL,1111,1,1,0,0.09
barcode12,5,70952201,G,DEL,1078,2,2,0,0.19
barcode12,5,70952202,G,DEL,1072,1,1,0,0.09
barcode12,5,70952203,T,DEL,1070,7,7,0,0.65
barcode09,5,70924859,C,DEL,689,1,0,1,0.15
barcode09,5,70924860,A,DEL,782,37,1,36,4.73
barcode09,5,70924863,A,DEL,1216,1,0,1,0.08
barcode09,5,70924864,C,DEL,1317,6,0,6,0.46
barcode09,5,70924865,A,DEL,1393,11,0,11,0.79
barcode09,5,70924867,A,DEL,1443,2,0,2,0.14
barcode09,5,70924868,C,DEL,1471,13,1,12,0.88
barcode09,5,70924869,A,DEL,1520,14,0,14,0.92
barcode09,5,70924870,A,DEL,1524,5,0,5,0.33
barcode09,5,70924871,A,DEL,1527,26,4,22,1.7
barcode09,5,70924872,C,DEL,1529,74,6,68,4.84
barcode09,5,70924873,A,DEL,1537,425,48,377,27.65
barcode09,5,70924874,A,DEL,1557,170,13,157,10.92
barcode09,5,70924875,A,DEL,1563,56,1,55,3.58
barcode09,5,70924876,A,DEL,1565,13,0,13,0.83
barcode09,5,70924877,A,DEL,1572,8,0,8,0.51
barcode09,5,70924878,A,DEL,1573,5,1,4,0.32
barcode09,5,70924879,A,DEL,1589,2,1,1,0.13
barcode09,5,70924880,A,DEL,1599,1,1,0,0.06
barcode09,5,70924881,A,DEL,1605,4,3,1,0.25
barcode09,5,70924882,A,DEL,1608,4,3,1,0.25
barcode09,5,70924883,G,DEL,1614,4,3,1,0.25
barcode09,5,70924884,G,DEL,1618,1,1,0,0.06
barcode09,5,70924885,A,DEL,1642,56,1,55,3.41
barcode09,5,70924890,A,DEL,1694,25,1,24,1.48
barcode09,5,70924891,A,DEL,1697,3,1,2,0.18
barcode09,5,70924892,A,DEL,1709,3,3,0,0.18
barcode09,5,70924893,T,DEL,1710,3,3,0,0.18
barcode09,5,70924894,A,DEL,1743,1,1,0,0.06
barcode09,5,70924895,T,DEL,1745,9,0,9,0.52
barcode09,5,70924896,A,DEL,1773,10,0,10,0.56
barcode09,5,70924901,A,DEL,2122,1,0,1,0.05
barcode09,5,70924902,G,DEL,2151,5,0,5,0.23
barcode09,5,70924903,T,DEL,2156,3,0,3,0.14
barcode09,5,70924904,G,DEL,2172,1,0,1,0.05
barcode09,5,70924905,A,DEL,2190,54,0,54,2.47
barcode09,5,70924909,G,DEL,2243,5,0,5,0.22
barcode09,5,70924910,A,DEL,2293,35,0,35,1.53
barcode09,5,70924911,A,DEL,2308,2,0,2,0.09
barcode09,5,70924913,G,DEL,2315,3,3,0,0.13
barcode09,5,70924915,A,DEL,2350,3,3,0,0.13
barcode09,5,70924916,T,DEL,2354,16,16,0,0.68
barcode09,5,70924917,T,DEL,2367,3,2,1,0.13
barcode09,5,70924918,G,DEL,2387,30,22,8,1.26
barcode09,5,70924919,A,DEL,2472,28,20,8,1.13
barcode09,5,70924920,G,DEL,2494,5,3,2,0.2
barcode09,5,70924921,A,DEL,2532,7,4,3,0.28
barcode09,5,70924922,G,DEL,2538,18,3,15,0.71
barcode09,5,70924923,A,DEL,2563,6,3,3,0.23
barcode09,5,70924924,A,DEL,2584,3,3,0,0.12
barcode09,5,70924926,T,DEL,2588,1,1,0,0.04
barcode09,5,70924927,G,DEL,2592,5,1,4,0.19
barcode09,5,70924928,A,DEL,2622,191,24,167,7.28
barcode09,5,70924929,A,DEL,2644,8,3,5,0.3
barcode09,5,70924930,A,DEL,2648,2,1,1,0.08
barcode09,5,70924931,A,DEL,2652,9,8,1,0.34
barcode09,5,70924932,A,DEL,2655,10,10,0,0.38
barcode09,5,70924933,T,DEL,2658,16,11,5,0.6
barcode09,5,70924934,A,DEL,2698,3,3,0,0.11
barcode09,5,70924935,T,DEL,2711,2,1,1,0.07
barcode09,5,70924936,A,DEL,2754,9,6,3,0.33
barcode09,5,70924937,C,DEL,2783,7,3,4,0.25
barcode09,5,70924938,A,DEL,2798,2,0,2,0.07
barcode09,5,70924939,C,DEL,2821,5,2,3,0.18
barcode09,5,70924940,G,DEL,2862,5,3,2,0.17
barcode09,5,70924941,C,DEL,2903,7,3,4,0.24
barcode09,5,70924942,C,DEL,2920,4,1,3,0.14
barcode09,5,70924943,A,DEL,2944,7,2,5,0.24
barcode09,5,70924944,C,DEL,2955,8,1,7,0.27
barcode09,5,70924945,A,DEL,2946,43,17,26,1.46
barcode09,5,70924946,A,DEL,2966,1,1,0,0.03
barcode09,5,70924947,A,DEL,2973,2,2,0,0.07
barcode09,5,70924948,T,DEL,2972,8,5,3,0.27
barcode09,5,70924949,G,DEL,2990,9,2,7,0.3
barcode09,5,70924950,T,DEL,3006,13,5,8,0.43
barcode09,5,70924951,G,DEL,3019,718,51,667,23.78
barcode09,5,70924952,G,DEL,3076,2,1,1,0.07
barcode09,5,70924954,A,DEL,3116,2,0,2,0.06
barcode09,5,70924955,G,DEL,3121,17,8,9,0.54
barcode09,5,70924958,C,DEL,3170,1,1,0,0.03
barcode09,5,70924959,G,DEL,3161,3,0,3,0.09
barcode09,5,70924962,A,DEL,3213,28,1,27,0.87
barcode09,5,70924963,A,DEL,3217,2,1,1,0.06
barcode09,5,70924964,C,DEL,3215,1,0,1,0.03
barcode09,5,70924965,C,DEL,3245,1,0,1,0.03
barcode09,5,70924967,C,DEL,3260,16,0,16,0.49
barcode09,5,70924968,T,DEL,3264,62,1,61,1.9
barcode09,5,70924969,C,DEL,3291,28,0,28,0.85
barcode09,5,70924970,G,DEL,3285,15,0,15,0.46
barcode09,5,70924971,T,DEL,3295,59,0,59,1.79
barcode09,5,70924972,A,DEL,3318,42,11,31,1.27
barcode09,5,70924973,G,DEL,3328,45,9,36,1.35
barcode09,5,70924974,A,DEL,3368,23,0,23,0.68
barcode09,5,70924975,A,DEL,3379,2,0,2,0.06
barcode09,5,70924980,T,DEL,3406,1,1,0,0.03
barcode09,5,70924981,G,DEL,3416,50,40,10,1.46
barcode09,5,70924982,A,DEL,3434,4,0,4,0.12
barcode09,5,70924983,G,DEL,3439,21,12,9,0.61
barcode09,5,70924984,A,DEL,3445,41,26,15,1.19
barcode09,5,70924985,A,DEL,3470,1,1,0,0.03
barcode09,5,70924987,T,DEL,3470,5,5,0,0.14
barcode09,5,70924988,T,DEL,3473,22,22,0,0.63
barcode09,5,70924989,A,DEL,3488,25,25,0,0.72
barcode09,5,70924990,C,DEL,3491,25,24,1,0.72
barcode09,5,70924991,T,DEL,3507,2,0,2,0.06
barcode09,5,70924992,A,DEL,3531,11,6,5,0.31
barcode09,5,70924993,C,DEL,3534,13,5,8,0.37
barcode09,5,70924994,A,DEL,3546,16,8,8,0.45
barcode09,5,70924996,G,DEL,3587,3,3,0,0.08
barcode09,5,70924997,C,DEL,3602,2,0,2,0.06
barcode09,5,70924998,G,DEL,3605,2,0,2,0.06
barcode09,5,70925000,T,DEL,3593,139,0,139,3.87
barcode09,5,70925001,C,DEL,3592,174,6,168,4.84
barcode09,5,70925002,C,DEL,3596,35,0,35,0.97
barcode09,5,70925003,T,DEL,3613,39,4,35,1.08
barcode09,5,70925004,C,DEL,3645,331,253,78,9.08
barcode09,5,70925005,C,DEL,3671,5,3,2,0.14
barcode09,5,70925006,C,DEL,3675,4,3,1,0.11
barcode09,5,70925007,G,DEL,3677,4,3,1,0.11
barcode09,5,70925008,G,DEL,3683,1,1,0,0.03
barcode09,5,70925009,C,DEL,3660,2,1,1,0.05
barcode09,5,70925010,C,DEL,3656,1,1,0,0.03
barcode09,5,70925011,A,DEL,3670,3,1,2,0.08
barcode09,5,70925012,C,DEL,3676,3,2,1,0.08
barcode09,5,70925014,G,DEL,3672,15,2,13,0.41
barcode09,5,70925015,T,DEL,3669,12,1,11,0.33
barcode09,5,70925016,A,DEL,3669,5,3,2,0.14
barcode09,5,70925017,C,DEL,3683,7,6,1,0.19
barcode09,5,70925018,T,DEL,3683,4,0,4,0.11
barcode09,5,70925019,G,DEL,3686,2,0,2,0.05
barcode09,5,70925020,T,DEL,3691,226,14,212,6.12
barcode09,5,70925021,T,DEL,3718,2,1,1,0.05
barcode09,5,70925022,C,DEL,3728,36,7,29,0.97
barcode09,5,70925023,C,DEL,3739,2,0,2,0.05
barcode09,5,70925024,G,DEL,3738,2,0,2,0.05
barcode09,5,70925025,C,DEL,3740,8,2,6,0.21
barcode09,5,70925026,T,DEL,3746,10,7,3,0.27
barcode09,5,70925027,C,DEL,3771,536,503,33,14.21
barcode09,5,70925029,C,DEL,3791,1,1,0,0.03
barcode09,5,70925030,A,DEL,3788,17,6,11,0.45
barcode09,5,70925031,G,DEL,3791,12,0,12,0.32
barcode09,5,70925032,A,DEL,3787,8,2,6,0.21
barcode09,5,70925033,A,DEL,3786,2,0,2,0.05
barcode09,5,70925034,G,DEL,3785,4,2,2,0.11
barcode09,5,70925035,C,DEL,3784,516,345,171,13.64
barcode09,5,70925036,C,DEL,3795,9,4,5,0.24
barcode09,5,70925037,C,DEL,3799,3,1,2,0.08
barcode09,5,70925038,C,DEL,3790,78,67,11,2.06
barcode09,5,70925039,G,DEL,3793,181,110,71,4.77
barcode09,5,70925040,G,DEL,3792,4,3,1,0.11
barcode09,5,70925041,G,DEL,3777,3,2,1,0.08
barcode09,5,70925044,G,DEL,3794,1,0,1,0.03
barcode09,5,70925045,C,DEL,3798,5,1,4,0.13
barcode09,5,70925046,G,DEL,3799,28,22,6,0.74
barcode09,5,70925047,G,DEL,3797,5,1,4,0.13
barcode09,5,70925048,A,DEL,3796,281,9,272,7.4
barcode09,5,70925050,G,DEL,3775,2,2,0,0.05
barcode09,5,70925052,C,DEL,3776,1,1,0,0.03
barcode09,5,70925053,G,DEL,3785,1,0,1,0.03
barcode09,5,70925054,T,DEL,3797,6,0,6,0.16
barcode09,5,70925055,C,DEL,3792,9,0,9,0.24
barcode09,5,70925056,A,DEL,3799,1,0,1,0.03
barcode09,5,70925057,C,DEL,3794,4,0,4,0.11
barcode09,5,70925058,T,DEL,3794,11,4,7,0.29
barcode09,5,70925059,C,DEL,3798,18,6,12,0.47
barcode09,5,70925060,T,DEL,3801,155,87,68,4.08
barcode09,5,70925061,T,DEL,3794,41,3,38,1.08
barcode09,5,70925062,A,DEL,3791,90,11,79,2.37
barcode09,5,70925063,A,DEL,3789,11,7,4,0.29
barcode09,5,70925064,G,DEL,3781,9,4,5,0.24
barcode09,5,70925065,A,DEL,3783,106,61,45,2.8
barcode09,5,70925066,A,DEL,3775,27,24,3,0.72
barcode09,5,70925067,G,DEL,3769,120,90,30,3.18
barcode09,5,70925068,G,DEL,3755,14,14,0,0.37
barcode09,5,70925069,G,DEL,3746,3,3,0,0.08
barcode09,5,70925070,A,DEL,3735,6,6,0,0.16
barcode09,5,70925071,C,DEL,3711,8,8,0,0.22
barcode09,5,70925072,G,DEL,3709,152,127,25,4.1
barcode09,5,70925073,G,DEL,3689,13,8,5,0.35
barcode09,5,70925074,G,DEL,3653,12,12,0,0.33
barcode09,5,70925075,G,DEL,3615,157,157,0,4.34
barcode09,5,70925076,C,DEL,3612,279,255,24,7.72
barcode09,5,70925077,C,DEL,3621,142,129,13,3.92
barcode09,5,70925078,C,DEL,3623,135,131,4,3.73
barcode09,5,70925079,C,DEL,3630,57,52,5,1.57
barcode09,5,70925080,A,DEL,3613,79,67,12,2.19
barcode09,5,70925081,C,DEL,3629,9,4,5,0.25
barcode09,5,70925082,G,DEL,3631,16,12,4,0.44
barcode09,5,70925083,C,DEL,3644,4,0,4,0.11
barcode09,5,70925084,T,DEL,3639,14,4,10,0.38
barcode09,5,70925085,G,DEL,3645,31,29,2,0.85
barcode09,5,70925086,C,DEL,3636,24,22,2,0.66
barcode09,5,70925087,G,DEL,3632,4,3,1,0.11
barcode09,5,70925088,C,DEL,3646,32,5,27,0.88
barcode09,5,70925089,A,DEL,3643,6,6,0,0.16
barcode09,5,70925090,C,DEL,3643,48,43,5,1.32
barcode09,5,70925091,C,DEL,3622,3,1,2,0.08
barcode09,5,70925092,C,DEL,3612,23,18,5,0.64
barcode09,5,70925093,G,DEL,3640,31,26,5,0.85
barcode09,5,70925094,C,DEL,3639,9,3,6,0.25
barcode09,5,70925095,G,DEL,3631,37,11,26,1.02
barcode09,5,70925097,G,DEL,3620,2,2,0,0.06
barcode09,5,70925098,T,DEL,3628,16,13,3,0.44
barcode09,5,70925099,T,DEL,3616,2,2,0,0.06
barcode09,5,70925100,T,DEL,3607,7,7,0,0.19
barcode09,5,70925101,G,DEL,3616,10,10,0,0.28
barcode09,5,70925102,C,DEL,3613,13,10,3,0.36
barcode09,5,70925103,T,DEL,3614,5,1,4,0.14
barcode09,5,70925104,A,DEL,3602,1,1,0,0.03
barcode09,5,70925108,C,DEL,3558,13,0,13,0.37
barcode09,5,70925109,G,DEL,3536,34,1,33,0.96
barcode09,5,70925110,A,DEL,3540,35,2,33,0.99
barcode09,5,70925111,T,DEL,3537,2,1,1,0.06
barcode09,5,70925112,G,DEL,3534,7,2,5,0.2
barcode09,5,70925113,A,DEL,3527,14,3,11,0.4
barcode09,5,70925114,G,DEL,3523,59,0,59,1.67
barcode09,5,70925115,C,DEL,3524,55,1,54,1.56
barcode09,5,70925116,A,DEL,3520,4,2,2,0.11
barcode09,5,70925117,G,DEL,3517,14,3,11,0.4
barcode09,5,70925118,C,DEL,3509,13,3,10,0.37
barcode09,5,70925119,G,DEL,3497,15,2,13,0.43
barcode09,5,70925120,G,DEL,3487,1,0,1,0.03
barcode09,5,70925121,C,DEL,3476,1,0,1,0.03
barcode09,5,70925122,G,DEL,3449,2,2,0,0.06
barcode09,5,70925123,G,DEL,3375,1,1,0,0.03
barcode09,5,70925124,C,DEL,3363,8,2,6,0.24
barcode09,5,70925125,A,DEL,3328,22,20,2,0.66
barcode09,5,70925126,G,DEL,3328,21,19,2,0.63
barcode09,5,70925127,T,DEL,3326,18,18,0,0.54
barcode09,5,70925128,G,DEL,3323,4,3,1,0.12
barcode09,5,70925129,G,DEL,3301,1,0,1,0.03
barcode09,5,70925130,T,DEL,3295,1,0,1,0.03
barcode09,5,70925131,G,DEL,3287,34,31,3,1.03
barcode09,5,70925132,G,DEL,3280,31,30,1,0.95
barcode09,5,70925133,C,DEL,3264,29,28,1,0.89
barcode09,5,70925134,G,DEL,3252,21,8,13,0.65
barcode09,5,70925135,G,DEL,3219,3,3,0,0.09
barcode09,5,70925136,C,DEL,3187,5,4,1,0.16
barcode09,5,70925137,G,DEL,3178,4,4,0,0.13
barcode09,5,70925138,T,DEL,3160,8,8,0,0.25
barcode09,5,70925139,C,DEL,3138,125,112,13,3.98
barcode09,5,70925140,C,DEL,3144,2,1,1,0.06
barcode09,5,70925141,C,DEL,3135,7,6,1,0.22
barcode09,5,70925142,G,DEL,3116,45,28,17,1.44
barcode09,5,70925143,G,DEL,3109,22,6,16,0.71
barcode09,5,70925144,A,DEL,3078,20,16,4,0.65
barcode09,5,70925145,G,DEL,3064,48,18,30,1.57
barcode09,5,70925146,C,DEL,3060,20,19,1,0.65
barcode09,5,70925147,A,DEL,3043,61,59,2,2.0
barcode09,5,70925148,G,DEL,3034,44,42,2,1.45
barcode09,5,70925149,G,DEL,3019,35,34,1,1.16
barcode09,5,70925150,A,DEL,3003,26,26,0,0.87
barcode09,5,70925151,G,DEL,2989,66,65,1,2.21
barcode09,5,70925152,G,DEL,2974,61,61,0,2.05
barcode09,5,70925153,A,DEL,2964,62,62,0,2.09
barcode09,5,70925154,T,DEL,2961,118,109,9,3.99
barcode09,5,70925155,T,DEL,2928,5,1,4,0.17
barcode09,5,70925156,C,DEL,2924,6,1,5,0.21
barcode09,5,70925157,C,DEL,2913,3,0,3,0.1
barcode09,5,70925158,G,DEL,2896,8,0,8,0.28
barcode09,5,70925159,T,DEL,2882,8,0,8,0.28
barcode09,5,70925160,G,DEL,2755,4,2,2,0.15
barcode09,5,70925161,C,DEL,2725,5,5,0,0.18
barcode09,5,70925162,T,DEL,2722,8,1,7,0.29
barcode09,5,70925163,G,DEL,2712,5,1,4,0.18
barcode09,5,70925164,T,DEL,2687,35,31,4,1.3
barcode09,5,70925165,T,DEL,2673,1,1,0,0.04
barcode09,5,70925166,C,DEL,2654,15,8,7,0.57
barcode09,5,70925167,C,DEL,2639,20,4,16,0.76
barcode09,5,70925168,G,DEL,2627,86,13,73,3.27
barcode09,5,70925169,G,DEL,2606,7,7,0,0.27
barcode09,5,70925170,C,DEL,2552,3,3,0,0.12
barcode09,5,70925171,G,DEL,2498,2,2,0,0.08
barcode09,5,70925172,C,DEL,2477,3,2,1,0.12
barcode09,5,70925175,C,DEL,2435,6,6,0,0.25
barcode09,5,70925176,A,DEL,2408,11,11,0,0.46
barcode09,5,70925177,C,DEL,2396,5,4,1,0.21
barcode09,5,70925178,A,DEL,2393,17,16,1,0.71
barcode09,5,70925179,G,DEL,2392,7,5,2,0.29
barcode09,5,70925180,G,DEL,2384,1,1,0,0.04
barcode09,5,70925181,C,DEL,2379,27,27,0,1.13
barcode09,5,70925182,C,DEL,2366,1,1,0,0.04
barcode09,5,70925183,A,DEL,2362,5,5,0,0.21
barcode09,5,70925187,G,DEL,2310,4,3,1,0.17
barcode09,5,70925188,A,DEL,2301,4,3,1,0.17
barcode09,5,70925189,G,DEL,2268,2,1,1,0.09
barcode09,5,70925191,T,DEL,2252,2,2,0,0.09
barcode09,5,70925192,C,DEL,2206,7,6,1,0.32
barcode09,5,70925193,G,DEL,2191,8,7,1,0.37
barcode09,5,70925194,C,DEL,2176,15,2,13,0.69
barcode09,5,70925195,A,DEL,2146,3,3,0,0.14
barcode09,5,70925196,G,DEL,2139,1,1,0,0.05
barcode09,5,70925197,C,DEL,2124,28,28,0,1.32
barcode09,5,70925198,C,DEL,2103,1,1,0,0.05
barcode09,5,70925199,A,DEL,2072,2,2,0,0.1
barcode09,5,70925201,T,DEL,2044,2,0,2,0.1
barcode09,5,70925202,G,DEL,2025,4,4,0,0.2
barcode09,5,70925203,C,DEL,1991,2,2,0,0.1
barcode09,5,70925205,G,DEL,1961,5,5,0,0.25
barcode09,5,70925206,T,DEL,1953,3,3,0,0.15
barcode09,5,70925207,C,DEL,1865,27,3,24,1.45
barcode09,5,70925208,T,DEL,1836,3,2,1,0.16
barcode09,5,70925209,C,DEL,1823,6,6,0,0.33
barcode09,5,70925213,A,DEL,774,18,18,0,2.33
barcode09,5,70938760,G,DEL,106,1,1,0,0.94
barcode09,5,70938766,T,DEL,601,1,0,1,0.17
barcode09,5,70938767,C,DEL,640,11,0,11,1.72
barcode09,5,70938768,T,DEL,718,61,6,55,8.5
barcode09,5,70938770,G,DEL,736,2,0,2,0.27
barcode09,5,70938772,T,DEL,757,16,0,16,2.11
barcode09,5,70938774,C,DEL,775,2,0,2,0.26
barcode09,5,70938775,T,DEL,780,2,0,2,0.26
barcode09,5,70938776,A,DEL,799,5,0,5,0.63
barcode09,5,70938780,T,DEL,829,1,0,1,0.12
barcode09,5,70938781,A,DEL,835,12,11,1,1.44
barcode09,5,70938782,C,DEL,839,3,0,3,0.36
barcode09,5,70938783,A,DEL,842,8,0,8,0.95
barcode09,5,70938784,T,DEL,842,49,29,20,5.82
barcode09,5,70938785,T,DEL,850,6,0,6,0.71
barcode09,5,70938786,T,DEL,863,2,2,0,0.23
barcode09,5,70938787,T,DEL,869,8,5,3,0.92
barcode09,5,70938788,C,DEL,885,20,11,9,2.26
barcode09,5,70938789,T,DEL,892,1,0,1,0.11
barcode09,5,70938790,G,DEL,897,15,0,15,1.67
barcode09,5,70938792,T,DEL,916,3,2,1,0.33
barcode09,5,70938794,A,DEL,920,30,0,30,3.26
barcode09,5,70938801,T,DEL,1020,3,1,2,0.29
barcode09,5,70938804,G,DEL,1054,27,0,27,2.56
barcode09,5,70938805,A,DEL,1060,50,0,50,4.72
barcode09,5,70938806,A,DEL,1063,2,1,1,0.19
barcode09,5,70938807,C,DEL,1126,2,1,1,0.18
barcode09,5,70938808,A,DEL,1147,5,0,5,0.44
barcode09,5,70938809,T,DEL,1149,2,0,2,0.17
barcode09,5,70938810,G,DEL,1182,4,2,2,0.34
barcode09,5,70938811,A,DEL,1209,1,1,0,0.08
barcode09,5,70938813,T,DEL,1242,2,1,1,0.16
barcode09,5,70938814,T,DEL,1245,2,1,1,0.16
barcode09,5,70938815,G,DEL,1266,4,2,2,0.32
barcode09,5,70938816,T,DEL,1271,111,59,52,8.73
barcode09,5,70938817,T,DEL,1278,45,42,3,3.52
barcode09,5,70938818,T,DEL,1290,7,7,0,0.54
barcode09,5,70938819,T,DEL,1292,7,7,0,0.54
barcode09,5,70938820,T,DEL,1293,8,8,0,0.62
barcode09,5,70938821,A,DEL,1302,10,9,1,0.77
barcode09,5,70938822,T,DEL,1307,16,8,8,1.22
barcode09,5,70938823,T,DEL,1323,9,9,0,0.68
barcode09,5,70938824,T,DEL,1325,10,10,0,0.75
barcode09,5,70938825,C,DEL,1346,12,11,1,0.89
barcode09,5,70938826,T,DEL,1352,27,27,0,2.0
barcode09,5,70938827,T,DEL,1357,1,0,1,0.07
barcode09,5,70938828,A,DEL,1374,4,3,1,0.29
barcode09,5,70938829,C,DEL,1376,30,5,25,2.18
barcode09,5,70938831,C,DEL,1381,1,1,0,0.07
barcode09,5,70938832,T,DEL,1385,25,21,4,1.81
barcode09,5,70938833,T,DEL,1387,1,1,0,0.07
barcode09,5,70938835,C,DEL,1405,7,6,1,0.5
barcode09,5,70938836,C,DEL,1422,1,1,0,0.07
barcode09,5,70938837,A,DEL,1422,6,6,0,0.42
barcode09,5,70938838,G,DEL,1429,1,1,0,0.07
barcode09,5,70938840,G,DEL,1433,1,1,0,0.07
barcode09,5,70938847,T,DEL,1428,5,4,1,0.35
barcode09,5,70938848,T,DEL,1432,5,5,0,0.35
barcode09,5,70938849,C,DEL,1452,7,6,1,0.48
barcode09,5,70938850,T,DEL,1451,7,3,4,0.48
barcode09,5,70938851,G,DEL,1454,17,0,17,1.17
barcode09,5,70938852,A,DEL,1457,4,0,4,0.27
barcode09,5,70938853,C,DEL,1450,1,0,1,0.07
barcode09,5,70938854,A,DEL,1449,1,1,0,0.07
barcode09,5,70938855,T,DEL,1449,12,8,4,0.83
barcode09,5,70938856,T,DEL,1463,2,2,0,0.14
barcode09,5,70938857,T,DEL,1463,1,1,0,0.07
barcode09,5,70938858,G,DEL,1471,51,2,49,3.47
barcode09,5,70938861,A,DEL,1468,3,1,2,0.2
barcode09,5,70938862,T,DEL,1470,1,0,1,0.07
barcode09,5,70938863,G,DEL,1469,1,1,0,0.07
barcode09,5,70938864,A,DEL,1476,4,1,3,0.27
barcode09,5,70938865,T,DEL,1461,4,0,4,0.27
barcode09,5,70938866,A,DEL,1507,3,3,0,0.2
barcode09,5,70938869,G,DEL,1502,8,0,8,0.53
barcode09,5,70938870,C,DEL,1520,2,0,2,0.13
barcode09,5,70938871,A,DEL,1479,1,0,1,0.07
barcode09,5,70938872,C,DEL,1479,2,1,1,0.14
barcode09,5,70938873,T,DEL,1474,1,0,1,0.07
barcode09,5,70938874,G,DEL,1459,1,0,1,0.07
barcode09,5,70938875,A,DEL,1462,1,0,1,0.07
barcode09,5,70938876,T,DEL,1452,1,0,1,0.07
barcode09,5,70938877,A,DEL,1402,49,36,13,3.5
barcode09,5,70938878,A,DEL,1405,1,1,0,0.07
barcode09,5,70938879,A,DEL,1400,1,1,0,0.07
barcode09,5,70938880,A,DEL,1389,1,1,0,0.07
barcode09,5,70938881,G,DEL,1383,1,1,0,0.07
barcode09,5,70938883,A,DEL,1381,1,1,0,0.07
barcode09,5,70938884,T,DEL,1380,1,1,0,0.07
barcode09,5,70938885,A,DEL,1372,1,1,0,0.07
barcode09,5,70938886,T,DEL,1372,1,1,0,0.07
barcode09,5,70938887,G,DEL,1368,1,1,0,0.07
barcode09,5,70938890,A,DEL,1333,6,2,4,0.45
barcode09,5,70938891,A,DEL,1328,1,0,1,0.08
barcode09,5,70938896,G,DEL,1286,1,1,0,0.08
barcode09,5,70938897,T,DEL,1273,1,1,0,0.08
barcode09,5,70938898,G,DEL,1235,1,1,0,0.08
barcode09,5,70938899,G,DEL,1203,1,1,0,0.08
barcode09,5,70938900,C,DEL,1185,5,0,5,0.42
barcode09,5,70938901,T,DEL,1181,5,5,0,0.42
barcode09,5,70938903,C,DEL,1134,1,0,1,0.09
barcode09,5,70938905,T,DEL,1131,11,4,7,0.97
barcode09,5,70938907,T,DEL,1127,1,0,1,0.09
barcode09,5,70938908,A,DEL,1120,23,2,21,2.05
barcode09,5,70938913,A,DEL,1080,4,1,3,0.37
barcode09,5,70938914,T,DEL,1074,1,1,0,0.09
barcode09,5,70938915,G,DEL,1063,1,1,0,0.09
barcode09,5,70938916,A,DEL,1044,3,0,3,0.29
barcode09,5,70938919,T,DEL,1020,32,32,0,3.14
barcode09,5,70938920,G,DEL,1015,32,32,0,3.15
barcode09,5,70938921,C,DEL,1012,31,31,0,3.06
barcode09,5,70938922,T,DEL,1011,34,34,0,3.36
barcode09,5,70938923,T,DEL,1004,1,1,0,0.1
barcode09,5,70938924,G,DEL,993,4,4,0,0.4
barcode09,5,70938925,C,DEL,963,3,2,1,0.31
barcode09,5,70938926,T,DEL,962,4,2,2,0.42
barcode09,5,70938928,A,DEL,933,2,2,0,0.21
barcode09,5,70938929,G,DEL,925,2,2,0,0.22
barcode09,5,70938931,C,DEL,898,2,2,0,0.22
barcode09,5,70938932,G,DEL,898,1,1,0,0.11
barcode09,5,70938933,T,DEL,896,46,46,0,5.13
barcode09,5,70938935,T,DEL,889,3,3,0,0.34
barcode09,5,70938936,T,DEL,883,7,7,0,0.79
barcode09,5,70938937,C,DEL,877,9,9,0,1.03
barcode09,5,70938938,T,DEL,877,1,0,1,0.11
barcode09,5,70938939,T,DEL,872,1,0,1,0.11
barcode09,5,70938941,T,DEL,870,105,105,0,12.07
barcode09,5,70938942,T,DEL,864,2,2,0,0.23
barcode09,5,70938943,T,DEL,860,1,1,0,0.12
barcode09,5,70938944,T,DEL,834,5,5,0,0.6
barcode09,5,70938945,C,DEL,825,7,6,1,0.85
barcode09,5,70941351,A,DEL,21,1,0,1,4.76
barcode09,5,70941357,T,DEL,265,3,0,3,1.13
barcode09,5,70941358,A,DEL,434,8,0,8,1.84
barcode09,5,70941363,G,DEL,629,1,0,1,0.16
barcode09,5,70941364,T,DEL,684,1,0,1,0.15
barcode09,5,70941366,C,DEL,712,2,0,2,0.28
barcode09,5,70941367,A,DEL,721,1,0,1,0.14
barcode09,5,70941368,T,DEL,730,190,4,186,26.03
barcode09,5,70941369,T,DEL,739,3,0,3,0.41
barcode09,5,70941374,T,DEL,772,3,2,1,0.39
barcode09,5,70941376,C,DEL,798,2,0,2,0.25
barcode09,5,70941377,C,DEL,799,5,0,5,0.63
barcode09,5,70941378,T,DEL,802,30,0,30,3.74
barcode09,5,70941380,T,DEL,830,39,9,30,4.7
barcode09,5,70941381,T,DEL,834,5,0,5,0.6
barcode09,5,70941383,T,DEL,849,9,0,9,1.06
barcode09,5,70941384,C,DEL,862,121,0,121,14.04
barcode09,5,70941385,G,DEL,890,1,0,1,0.11
barcode09,5,70941386,T,DEL,891,47,0,47,5.27
barcode09,5,70941388,G,DEL,899,1,0,1,0.11
barcode09,5,70941390,A,DEL,918,1,1,0,0.11
barcode09,5,70941391,T,DEL,921,1,0,1,0.11
barcode09,5,70941392,G,DEL,930,1,0,1,0.11
barcode09,5,70941393,C,DEL,950,7,5,2,0.74
barcode09,5,70941394,T,DEL,980,5,3,2,0.51
barcode09,5,70941395,C,DEL,1012,18,5,13,1.78
barcode09,5,70941396,T,DEL,1025,41,0,41,4.0
barcode09,5,70941397,A,DEL,1047,61,0,61,5.83
barcode09,5,70941398,A,DEL,1051,2,0,2,0.19
barcode09,5,70941399,A,DEL,1055,1,0,1,0.09
barcode09,5,70941400,G,DEL,1060,3,0,3,0.28
barcode09,5,70941401,A,DEL,1077,12,10,2,1.11
barcode09,5,70941402,A,DEL,1079,2,0,2,0.19
barcode09,5,70941403,T,DEL,1086,3,1,2,0.28
barcode09,5,70941404,G,DEL,1096,2,1,1,0.18
barcode09,5,70941405,G,DEL,1133,1,1,0,0.09
barcode09,5,70941406,T,DEL,1134,1,1,0,0.09
barcode09,5,70941407,G,DEL,1146,4,2,2,0.35
barcode09,5,70941408,A,DEL,1151,14,1,13,1.22
barcode09,5,70941409,C,DEL,1180,2,0,2,0.17
barcode09,5,70941410,A,DEL,1200,1,0,1,0.08
barcode09,5,70941411,T,DEL,1201,17,12,5,1.42
barcode09,5,70941413,T,DEL,1213,22,22,0,1.81
barcode09,5,70941414,G,DEL,1227,32,32,0,2.61
barcode09,5,70941415,T,DEL,1231,8,8,0,0.65
barcode09,5,70941416,G,DEL,1232,11,5,6,0.89
barcode09,5,70941417,A,DEL,1236,79,12,67,6.39
barcode09,5,70941420,C,DEL,1242,2,0,2,0.16
barcode09,5,70941421,T,DEL,1280,39,39,0,3.05
barcode09,5,70941422,T,DEL,1335,1,1,0,0.07
barcode09,5,70941423,C,DEL,1342,22,20,2,1.64
barcode09,5,70941424,G,DEL,1393,48,0,48,3.45
barcode09,5,70941425,G,DEL,1407,4,0,4,0.28
barcode09,5,70941426,G,DEL,1405,5,0,5,0.36
barcode09,5,70941427,T,DEL,1411,11,0,11,0.78
barcode09,5,70941428,A,DEL,1410,27,3,24,1.91
barcode09,5,70941429,A,DEL,1417,1,0,1,0.07
barcode09,5,70941430,A,DEL,1427,1,0,1,0.07
barcode09,5,70941431,C,DEL,1430,23,19,4,1.61
barcode09,5,70941432,C,DEL,1436,1,0,1,0.07
barcode09,5,70941433,A,DEL,1437,148,19,129,10.3
barcode09,5,70941434,A,DEL,1441,3,2,1,0.21
barcode09,5,70941435,A,DEL,1442,1,0,1,0.07
barcode09,5,70941436,A,DEL,1446,1,0,1,0.07
barcode09,5,70941437,A,DEL,1448,2,1,1,0.14
barcode09,5,70941438,C,DEL,1448,4,3,1,0.28
barcode09,5,70941439,C,DEL,1461,2,1,1,0.14
barcode09,5,70941440,A,DEL,1460,2,2,0,0.14
barcode09,5,70941442,A,DEL,1473,1,1,0,0.07
barcode09,5,70941443,C,DEL,1473,5,2,3,0.34
barcode09,5,70941445,T,DEL,1474,2,0,2,0.14
barcode09,5,70941446,A,DEL,1482,107,26,81,7.22
barcode09,5,70941447,A,DEL,1481,6,4,2,0.41
barcode09,5,70941448,A,DEL,1481,6,4,2,0.41
barcode09,5,70941449,A,DEL,1477,5,4,1,0.34
barcode09,5,70941450,G,DEL,1471,8,6,2,0.54
barcode09,5,70941451,A,DEL,1469,19,3,16,1.29
barcode09,5,70941455,C,DEL,1474,1,1,0,0.07
barcode09,5,70941456,C,DEL,1475,1,1,0,0.07
barcode09,5,70941457,T,DEL,1476,4,1,3,0.27
barcode09,5,70941458,G,DEL,1488,2,2,0,0.13
barcode09,5,70941459,C,DEL,1493,2,1,1,0.13
barcode09,5,70941460,T,DEL,1496,1,1,0,0.07
barcode09,5,70941461,A,DEL,1486,88,76,12,5.92
barcode09,5,70941462,A,DEL,1497,54,49,5,3.61
barcode09,5,70941463,G,DEL,1487,56,49,7,3.77
barcode09,5,70941464,A,DEL,1494,46,42,4,3.08
barcode09,5,70941465,A,DEL,1500,59,58,1,3.93
barcode09,5,70941466,G,DEL,1491,87,85,2,5.84
barcode09,5,70941467,A,DEL,1483,18,9,9,1.21
barcode09,5,70941468,A,DEL,1478,12,3,9,0.81
barcode09,5,70941469,T,DEL,1473,13,2,11,0.88
barcode09,5,70941470,A,DEL,1471,49,20,29,3.33
barcode09,5,70941471,A,DEL,1472,2,0,2,0.14
barcode09,5,70941474,G,DEL,1464,2,1,1,0.14
barcode09,5,70941475,C,DEL,1464,3,3,0,0.2
barcode09,5,70941477,A,DEL,1457,174,36,138,11.94
barcode09,5,70941478,A,DEL,1458,18,2,16,1.23
barcode09,5,70941479,A,DEL,1445,22,17,5,1.52
barcode09,5,70941480,A,DEL,1434,24,19,5,1.67
barcode09,5,70941481,G,DEL,1431,26,20,6,1.82
barcode09,5,70941482,A,DEL,1430,31,5,26,2.17
barcode09,5,70941483,A,DEL,1425,11,11,0,0.77
barcode09,5,70941484,G,DEL,1416,13,13,0,0.92
barcode09,5,70941485,A,DEL,1399,78,69,9,5.58
barcode09,5,70941487,T,DEL,1389,2,2,0,0.14
barcode09,5,70941488,A,DEL,1383,5,3,2,0.36
barcode09,5,70941489,C,DEL,1381,3,2,1,0.22
barcode09,5,70941492,C,DEL,1385,1,0,1,0.07
barcode09,5,70941494,G,DEL,1338,1,0,1,0.07
barcode09,5,70941495,C,DEL,1318,43,0,43,3.26
barcode09,5,70941496,T,DEL,1315,55,50,5,4.18
barcode09,5,70941499,C,DEL,1269,1,0,1,0.08
barcode09,5,70941500,T,DEL,1268,83,82,1,6.55
barcode09,5,70941502,A,DEL,1223,13,13,0,1.06
barcode09,5,70941504,A,DEL,1165,1,0,1,0.09
barcode09,5,70941513,T,DEL,1086,27,26,1,2.49
barcode09,5,70941516,T,DEL,1074,3,3,0,0.28
barcode09,5,70941517,A,DEL,1068,27,24,3,2.53
barcode09,5,70941523,T,DEL,1055,95,95,0,9.0
barcode09,5,70941524,T,DEL,1049,6,6,0,0.57
barcode09,5,70941525,G,DEL,1038,19,19,0,1.83
barcode09,5,70941527,G,DEL,1020,6,6,0,0.59
barcode09,5,70941528,A,DEL,1003,1,1,0,0.1
barcode09,5,70941529,T,DEL,1003,33,32,1,3.29
barcode09,5,70941531,T,DEL,985,1,0,1,0.1
barcode09,5,70941532,A,DEL,981,1,0,1,0.1
barcode09,5,70941533,A,DEL,975,1,1,0,0.1
barcode09,5,70941534,C,DEL,971,1,1,0,0.1
barcode09,5,70941535,T,DEL,970,54,54,0,5.57
barcode09,5,70941537,C,DEL,947,2,1,1,0.21
barcode09,5,70942315,A,DEL,137,1,1,0,0.73
barcode09,5,70942323,T,DEL,224,1,1,0,0.45
barcode09,5,70942324,G,DEL,246,1,1,0,0.41
barcode09,5,70942327,T,DEL,249,1,0,1,0.4
barcode09,5,70942328,G,DEL,250,1,0,1,0.4
barcode09,5,70942329,C,DEL,262,1,0,1,0.38
barcode09,5,70942331,T,DEL,269,2,0,2,0.74
barcode09,5,70942332,G,DEL,270,1,0,1,0.37
barcode09,5,70942333,T,DEL,270,9,0,9,3.33
barcode09,5,70942334,A,DEL,272,2,0,2,0.74
barcode09,5,70942339,T,DEL,278,6,0,6,2.16
barcode09,5,70942340,C,DEL,280,1,0,1,0.36
barcode09,5,70942341,T,DEL,283,12,8,4,4.24
barcode09,5,70942342,T,DEL,393,2,0,2,0.51
barcode09,5,70942343,T,DEL,395,2,0,2,0.51
barcode09,5,70942344,G,DEL,396,9,0,9,2.27
barcode09,5,70942346,T,DEL,398,1,1,0,0.25
barcode09,5,70942347,T,DEL,399,1,1,0,0.25
barcode09,5,70942348,T,DEL,400,1,1,0,0.25
barcode09,5,70942350,T,DEL,405,39,19,20,9.63
barcode09,5,70942355,T,DEL,536,2,0,2,0.37
barcode09,5,70942359,G,DEL,607,3,3,0,0.49
barcode09,5,70942361,A,DEL,609,72,8,64,11.82
barcode09,5,70942362,A,DEL,609,2,0,2,0.33
barcode09,5,70942365,T,DEL,615,1,1,0,0.16
barcode09,5,70942366,T,DEL,630,2,0,2,0.32
barcode09,5,70942367,G,DEL,631,46,12,34,7.29
barcode09,5,70942368,G,DEL,633,1,0,1,0.16
barcode09,5,70942369,G,DEL,633,1,0,1,0.16
barcode09,5,70942370,G,DEL,632,1,0,1,0.16
barcode09,5,70942371,A,DEL,632,2,0,2,0.32
barcode09,5,70942372,C,DEL,632,6,0,6,0.95
barcode09,5,70942373,A,DEL,637,18,2,16,2.83
barcode09,5,70942374,A,DEL,642,1,1,0,0.16
barcode09,5,70942375,A,DEL,642,1,1,0,0.16
barcode09,5,70942376,T,DEL,643,2,2,0,0.31
barcode09,5,70942378,T,DEL,649,4,4,0,0.62
barcode09,5,70942379,T,DEL,652,1,1,0,0.15
barcode09,5,70942380,C,DEL,656,3,0,3,0.46
barcode09,5,70942381,T,DEL,657,2,1,1,0.3
barcode09,5,70942382,G,DEL,660,5,5,0,0.76
barcode09,5,70942383,C,DEL,659,4,4,0,0.61
barcode09,5,70942386,T,DEL,659,18,16,2,2.73
barcode09,5,70942388,T,DEL,662,3,3,0,0.45
barcode09,5,70942389,G,DEL,662,3,3,0,0.45
barcode09,5,70942390,G,DEL,662,3,3,0,0.45
barcode09,5,70942392,C,DEL,663,4,4,0,0.6
barcode09,5,70942393,A,DEL,666,23,1,22,3.45
barcode09,5,70942394,G,DEL,667,24,0,24,3.6
barcode09,5,70942395,A,DEL,667,3,2,1,0.45
barcode09,5,70942396,A,DEL,667,1,1,0,0.15
barcode09,5,70942397,G,DEL,668,4,3,1,0.6
barcode09,5,70942398,A,DEL,670,17,17,0,2.54
barcode09,5,70942399,C,DEL,670,4,4,0,0.6
barcode09,5,70942400,G,DEL,671,3,2,1,0.45
barcode09,5,70942401,G,DEL,672,2,2,0,0.3
barcode09,5,70942402,T,DEL,674,50,49,1,7.42
barcode09,5,70942403,T,DEL,673,1,0,1,0.15
barcode09,5,70942404,G,DEL,675,2,0,2,0.3
barcode09,5,70942405,C,DEL,677,3,1,2,0.44
barcode09,5,70942407,T,DEL,681,49,39,10,7.2
barcode09,5,70942408,T,DEL,700,1,1,0,0.14
barcode09,5,70942410,A,DEL,718,1,1,0,0.14
barcode09,5,70942411,C,DEL,719,30,30,0,4.17
barcode09,5,70942418,A,DEL,729,6,6,0,0.82
barcode09,5,70942419,C,DEL,728,6,6,0,0.82
barcode09,5,70942420,C,DEL,731,3,3,0,0.41
barcode09,5,70942422,T,DEL,734,3,3,0,0.41
barcode09,5,70942424,G,DEL,766,1,1,0,0.13
barcode09,5,70942425,C,DEL,769,1,1,0,0.13
barcode09,5,70942426,T,DEL,779,21,21,0,2.7
barcode09,5,70942429,A,DEL,811,5,4,1,0.62
barcode09,5,70942435,T,DEL,808,35,32,3,4.33
barcode09,5,70942436,T,DEL,805,2,2,0,0.25
barcode09,5,70942437,T,DEL,802,16,16,0,2.0
barcode09,5,70942438,T,DEL,798,61,61,0,7.64
barcode09,5,70942439,A,DEL,795,126,116,10,15.85
barcode09,5,70942440,A,DEL,796,66,65,1,8.29
barcode09,5,70942441,G,DEL,796,49,47,2,6.16
barcode09,5,70942442,A,DEL,802,30,30,0,3.74
barcode09,5,70942443,G,DEL,807,4,3,1,0.5
barcode09,5,70942444,A,DEL,812,12,12,0,1.48
barcode09,5,70942445,G,DEL,808,12,10,2,1.49
barcode09,5,70942446,A,DEL,808,6,2,4,0.74
barcode09,5,70942449,C,DEL,819,2,2,0,0.24
barcode09,5,70942451,T,DEL,845,1,1,0,0.12
barcode09,5,70942452,G,DEL,844,1,1,0,0.12
barcode09,5,70942453,T,DEL,844,1,1,0,0.12
barcode09,5,70942454,G,DEL,842,1,1,0,0.12
barcode09,5,70942455,T,DEL,846,1,1,0,0.12
barcode09,5,70942459,G,DEL,865,1,0,1,0.12
barcode09,5,70942461,T,DEL,857,2,2,0,0.23
barcode09,5,70942463,T,DEL,857,1,1,0,0.12
barcode09,5,70942464,A,DEL,857,5,5,0,0.58
barcode09,5,70942465,C,DEL,895,3,3,0,0.34
barcode09,5,70942466,A,DEL,895,1,1,0,0.11
barcode09,5,70942467,C,DEL,897,1,1,0,0.11
barcode09,5,70942469,G,DEL,899,2,1,1,0.22
barcode09,5,70942477,A,DEL,877,4,1,3,0.46
barcode09,5,70942478,A,DEL,876,1,1,0,0.11
barcode09,5,70942479,A,DEL,874,2,2,0,0.23
barcode09,5,70942480,T,DEL,875,2,2,0,0.23
barcode09,5,70942481,A,DEL,859,20,15,5,2.33
barcode09,5,70942482,G,DEL,859,11,6,5,1.28
barcode09,5,70942483,A,DEL,861,7,7,0,0.81
barcode09,5,70942484,G,DEL,862,16,16,0,1.86
barcode09,5,70942485,A,DEL,860,16,16,0,1.86
barcode09,5,70942486,G,DEL,854,53,52,1,6.21
barcode09,5,70942487,G,DEL,850,8,8,0,0.94
barcode09,5,70942488,A,DEL,849,6,6,0,0.71
barcode09,5,70942489,G,DEL,848,4,4,0,0.47
barcode09,5,70942490,C,DEL,846,4,1,3,0.47
barcode09,5,70942491,A,DEL,845,18,12,6,2.13
barcode09,5,70942492,A,DEL,845,1,1,0,0.12
barcode09,5,70942493,A,DEL,843,1,1,0,0.12
barcode09,5,70942494,A,DEL,838,10,0,10,1.19
barcode09,5,70942495,T,DEL,834,14,3,11,1.68
barcode09,5,70942496,C,DEL,826,6,5,1,0.73
barcode09,5,70942497,T,DEL,825,2,0,2,0.24
barcode09,5,70942499,T,DEL,827,5,5,0,0.6
barcode09,5,70942500,C,DEL,819,5,5,0,0.61
barcode09,5,70942501,C,DEL,821,1,1,0,0.12
barcode09,5,70942502,G,DEL,822,5,1,4,0.61
barcode09,5,70942504,T,DEL,820,2,2,0,0.24
barcode09,5,70942505,C,DEL,816,2,2,0,0.25
barcode09,5,70942506,T,DEL,817,3,0,3,0.37
barcode09,5,70942507,A,DEL,815,3,3,0,0.37
barcode09,5,70942508,C,DEL,816,2,2,0,0.25
barcode09,5,70942509,T,DEL,817,37,31,6,4.53
barcode09,5,70942510,T,DEL,826,3,0,3,0.36
barcode09,5,70942511,T,DEL,824,115,107,8,13.96
barcode09,5,70942512,C,DEL,825,295,282,13,35.76
barcode09,5,70942513,C,DEL,913,27,27,0,2.96
barcode09,5,70942516,A,DEL,918,2,2,0,0.22
barcode09,5,70942517,A,DEL,916,2,2,0,0.22
barcode09,5,70942518,T,DEL,915,6,5,1,0.66
barcode09,5,70942519,C,DEL,944,4,4,0,0.42
barcode09,5,70942522,T,DEL,947,1,1,0,0.11
barcode09,5,70942524,A,DEL,946,5,0,5,0.53
barcode09,5,70942526,G,DEL,942,1,1,0,0.11
barcode09,5,70942531,T,DEL,928,5,4,1,0.54
barcode09,5,70942532,A,DEL,913,7,4,3,0.77
barcode09,5,70942533,A,DEL,909,5,4,1,0.55
barcode09,5,70942535,A,DEL,896,1,1,0,0.11
barcode09,5,70942536,A,DEL,893,2,2,0,0.22
barcode09,5,70942537,T,DEL,893,2,2,0,0.22
barcode09,5,70942539,T,DEL,880,3,3,0,0.34
barcode09,5,70942540,A,DEL,873,4,2,2,0.46
barcode09,5,70942541,G,DEL,865,21,19,2,2.43
barcode09,5,70942542,A,DEL,864,5,0,5,0.58
barcode09,5,70942545,A,DEL,849,4,3,1,0.47
barcode09,5,70942557,A,DEL,786,22,22,0,2.8
barcode09,5,70942560,T,DEL,775,1,1,0,0.13
barcode09,5,70942563,G,DEL,763,1,1,0,0.13
barcode09,5,70942565,A,DEL,743,1,1,0,0.13
barcode09,5,70942569,A,DEL,703,96,96,0,13.66
barcode09,5,70942570,A,DEL,700,78,78,0,11.14
barcode09,5,70942571,A,DEL,699,37,37,0,5.29
barcode09,5,70942572,A,DEL,697,10,10,0,1.43
barcode09,5,70942580,A,DEL,316,1,1,0,0.32
barcode09,5,70942581,A,DEL,276,1,1,0,0.36
barcode09,5,70942582,T,DEL,265,1,1,0,0.38
barcode09,5,70942678,A,DEL,219,1,0,1,0.46
barcode09,5,70942682,T,DEL,274,1,0,1,0.36
barcode09,5,70942683,T,DEL,276,1,0,1,0.36
barcode09,5,70942686,A,DEL,291,1,0,1,0.34
barcode09,5,70942687,A,DEL,291,1,0,1,0.34
barcode09,5,70942688,C,DEL,291,1,0,1,0.34
barcode09,5,70942689,A,DEL,293,18,5,13,6.14
barcode09,5,70942697,G,DEL,300,1,0,1,0.33
barcode09,5,70942698,C,DEL,301,1,0,1,0.33
barcode09,5,70942699,A,DEL,301,2,0,2,0.66
barcode09,5,70942700,T,DEL,301,5,0,5,1.66
barcode09,5,70942701,A,DEL,303,2,0,2,0.66
barcode09,5,70942702,T,DEL,303,4,0,4,1.32
barcode09,5,70942703,T,DEL,304,2,0,2,0.66
barcode09,5,70942704,T,DEL,305,2,0,2,0.66
barcode09,5,70942705,T,DEL,305,3,0,3,0.98
barcode09,5,70942706,T,DEL,307,3,0,3,0.98
barcode09,5,70942707,T,DEL,307,9,0,9,2.93
barcode09,5,70942708,C,DEL,308,12,0,12,3.9
barcode09,5,70942709,T,DEL,309,50,3,47,16.18
barcode09,5,70942710,T,DEL,310,8,0,8,2.58
barcode09,5,70942711,T,DEL,310,2,0,2,0.65
barcode09,5,70942712,T,DEL,310,1,0,1,0.32
barcode09,5,70942713,T,DEL,311,4,0,4,1.29
barcode09,5,70942714,A,DEL,314,15,0,15,4.78
barcode09,5,70942718,A,DEL,317,3,0,3,0.95
barcode09,5,70942721,G,DEL,317,4,0,4,1.26
barcode09,5,70942722,A,DEL,318,30,3,27,9.43
barcode09,5,70942723,A,DEL,319,3,0,3,0.94
barcode09,5,70942727,G,DEL,321,25,0,25,7.79
barcode09,5,70942728,A,DEL,322,1,0,1,0.31
barcode09,5,70942734,A,DEL,327,9,0,9,2.75
barcode09,5,70942737,T,DEL,326,2,1,1,0.61
barcode09,5,70942740,C,DEL,329,1,1,0,0.3
barcode09,5,70942741,A,DEL,330,2,0,2,0.61
barcode09,5,70942743,C,DEL,333,2,0,2,0.6
barcode09,5,70942746,A,DEL,332,3,0,3,0.9
barcode09,5,70942749,A,DEL,334,26,0,26,7.78
barcode09,5,70942754,G,DEL,336,3,0,3,0.89
barcode09,5,70942755,A,DEL,335,4,0,4,1.19
barcode09,5,70942756,G,DEL,335,2,0,2,0.6
barcode09,5,70942757,A,DEL,337,13,0,13,3.86
barcode09,5,70942759,C,DEL,339,2,0,2,0.59
barcode09,5,70942761,C,DEL,349,3,0,3,0.86
barcode09,5,70942764,G,DEL,350,4,2,2,1.14
barcode09,5,70942765,G,DEL,349,3,0,3,0.86
barcode09,5,70942766,T,DEL,350,8,0,8,2.29
barcode09,5,70942767,C,DEL,350,16,0,16,4.57
barcode09,5,70942768,T,DEL,350,4,0,4,1.14
barcode09,5,70942769,C,DEL,354,7,0,7,1.98
barcode09,5,70942770,C,DEL,363,2,0,2,0.55
barcode09,5,70942772,G,DEL,363,2,0,2,0.55
barcode09,5,70942773,G,DEL,363,2,0,2,0.55
barcode09,5,70942774,A,DEL,362,18,0,18,4.97
barcode09,5,70942775,A,DEL,362,3,0,3,0.83
barcode09,5,70942776,A,DEL,360,2,0,2,0.56
barcode09,5,70942777,T,DEL,360,3,0,3,0.83
barcode09,5,70942778,A,DEL,360,2,0,2,0.56
barcode09,5,70942783,A,DEL,366,1,0,1,0.27
barcode09,5,70942793,A,DEL,274,3,0,3,1.09
barcode09,5,70942796,C,DEL,274,7,5,2,2.55
barcode09,5,70942802,T,DEL,252,7,0,7,2.78
barcode09,5,70942803,C,DEL,255,6,0,6,2.35
barcode09,5,70942804,T,DEL,260,2,0,2,0.77
barcode09,5,70942818,C,DEL,267,2,1,1,0.75
barcode09,5,70942819,T,DEL,266,16,2,14,6.02
barcode09,5,70942820,T,DEL,267,7,0,7,2.62
barcode09,5,70942821,T,DEL,264,5,0,5,1.89
barcode09,5,70942822,T,DEL,258,12,0,12,4.65
barcode09,5,70942823,C,DEL,258,21,1,20,8.14
barcode09,5,70942824,T,DEL,259,20,2,18,7.72
barcode09,5,70942825,C,DEL,264,44,11,33,16.67
barcode09,5,70942826,C,DEL,265,16,1,15,6.04
barcode09,5,70942827,C,DEL,262,7,0,7,2.67
barcode09,5,70942828,T,DEL,263,6,0,6,2.28
barcode09,5,70942829,C,DEL,259,16,4,12,6.18
barcode09,5,70942830,C,DEL,261,7,3,4,2.68
barcode09,5,70942831,A,DEL,262,4,3,1,1.53
barcode09,5,70942833,C,DEL,260,2,1,1,0.77
barcode09,5,70942834,A,DEL,260,2,1,1,0.77
barcode09,5,70942835,C,DEL,258,58,51,7,22.48
barcode09,5,70942836,C,DEL,245,3,3,0,1.22
barcode09,5,70942837,C,DEL,245,1,1,0,0.41
barcode09,5,70942844,C,DEL,244,7,7,0,2.87
barcode09,5,70942847,G,DEL,244,3,2,1,1.23
barcode09,5,70942848,G,DEL,243,1,0,1,0.41
barcode09,5,70942849,G,DEL,243,1,0,1,0.41
barcode09,5,70942850,C,DEL,241,1,0,1,0.41
barcode09,5,70942852,A,DEL,241,20,2,18,8.3
barcode09,5,70942855,A,DEL,240,1,1,0,0.42
barcode09,5,70942856,C,DEL,240,1,1,0,0.42
barcode09,5,70942857,T,DEL,240,9,1,8,3.75
barcode09,5,70942858,G,DEL,239,9,0,9,3.77
barcode09,5,70942861,A,DEL,235,1,0,1,0.43
barcode09,5,70942865,G,DEL,232,1,1,0,0.43
barcode09,5,70942867,A,DEL,228,11,3,8,4.82
barcode09,5,70942868,A,DEL,226,1,0,1,0.44
barcode09,5,70942869,A,DEL,225,1,0,1,0.44
barcode09,5,70942870,G,DEL,222,1,0,1,0.45
barcode09,5,70942871,G,DEL,223,1,0,1,0.45
barcode09,5,70942872,T,DEL,223,6,0,6,2.69
barcode09,5,70942881,T,DEL,217,7,0,7,3.23
barcode09,5,70942885,A,DEL,214,9,0,9,4.21
barcode09,5,70942886,A,DEL,214,1,0,1,0.47
barcode09,5,70942888,G,DEL,213,1,0,1,0.47
barcode09,5,70942889,T,DEL,213,2,2,0,0.94
barcode09,5,70942893,C,DEL,209,1,1,0,0.48
barcode09,5,70942894,C,DEL,208,1,0,1,0.48
barcode09,5,70942895,A,DEL,207,9,8,1,4.35
barcode09,5,70942896,G,DEL,206,10,9,1,4.85
barcode09,5,70942897,A,DEL,200,5,1,4,2.5
barcode09,5,70942904,T,DEL,192,1,1,0,0.52
barcode09,5,70942906,A,DEL,191,30,0,30,15.71
barcode09,5,70942908,T,DEL,189,1,1,0,0.53
barcode09,5,70942909,G,DEL,189,1,1,0,0.53
barcode09,5,70942911,C,DEL,189,12,11,1,6.35
barcode09,5,70942912,G,DEL,189,4,1,3,2.12
barcode09,5,70942916,C,DEL,176,1,1,0,0.57
barcode09,5,70942918,T,DEL,176,6,4,2,3.41
barcode09,5,70942921,A,DEL,171,1,0,1,0.58
barcode09,5,70942924,C,DEL,170,2,1,1,1.18
barcode09,5,70942925,T,DEL,170,3,1,2,1.76
barcode09,5,70942929,T,DEL,165,1,0,1,0.61
barcode09,5,70942930,G,DEL,162,1,1,0,0.62
barcode09,5,70942931,T,DEL,160,3,3,0,1.88
barcode09,5,70942939,T,DEL,138,4,4,0,2.9
barcode09,5,70942940,T,DEL,138,1,1,0,0.72
barcode09,5,70942941,T,DEL,106,1,1,0,0.94
barcode09,5,70942942,G,DEL,101,1,1,0,0.99
barcode09,5,70942948,C,DEL,86,1,0,1,1.16
barcode09,5,70944618,A,DEL,390,1,0,1,0.26
barcode09,5,70944623,G,DEL,437,2,0,2,0.46
barcode09,5,70944625,T,DEL,445,1,0,1,0.22
barcode09,5,70944626,A,DEL,455,18,0,18,3.96
barcode09,5,70944628,G,DEL,465,2,0,2,0.43
barcode09,5,70944629,T,DEL,470,1,1,0,0.21
barcode09,5,70944633,T,DEL,477,17,0,17,3.56
barcode09,5,70944639,T,DEL,493,13,3,10,2.64
barcode09,5,70944640,T,DEL,497,4,0,4,0.8
barcode09,5,70944641,T,DEL,498,4,0,4,0.8
barcode09,5,70944642,G,DEL,500,13,0,13,2.6
barcode09,5,70944643,A,DEL,504,5,1,4,0.99
barcode09,5,70944646,T,DEL,506,1,0,1,0.2
barcode09,5,70944648,T,DEL,512,3,1,2,0.59
barcode09,5,70944649,T,DEL,514,9,0,9,1.75
barcode09,5,70944650,C,DEL,517,9,0,9,1.74
barcode09,5,70944651,C,DEL,522,1,0,1,0.19
barcode09,5,70944652,T,DEL,523,8,0,8,1.53
barcode09,5,70944653,T,DEL,525,7,0,7,1.33
barcode09,5,70944661,G,DEL,566,2,2,0,0.35
barcode09,5,70944662,G,DEL,568,1,1,0,0.18
barcode09,5,70944663,T,DEL,569,3,1,2,0.53
barcode09,5,70944664,C,DEL,569,4,1,3,0.7
barcode09,5,70944665,T,DEL,569,5,0,5,0.88
barcode09,5,70944666,A,DEL,571,7,0,7,1.23
barcode09,5,70944668,A,DEL,572,2,0,2,0.35
barcode09,5,70944669,A,DEL,571,6,0,6,1.05
barcode09,5,70944670,T,DEL,573,6,0,6,1.05
barcode09,5,70944671,T,DEL,579,2,0,2,0.35
barcode09,5,70944672,C,DEL,580,1,0,1,0.17
barcode09,5,70944673,A,DEL,582,3,0,3,0.52
barcode09,5,70944674,A,DEL,587,1,0,1,0.17
barcode09,5,70944675,T,DEL,587,1,0,1,0.17
barcode09,5,70944676,G,DEL,589,1,0,1,0.17
barcode09,5,70944678,C,DEL,593,14,0,14,2.36
barcode09,5,70944679,C,DEL,601,2,1,1,0.33
barcode09,5,70944680,C,DEL,603,2,1,1,0.33
barcode09,5,70944681,A,DEL,607,3,2,1,0.49
barcode09,5,70944685,C,DEL,620,1,1,0,0.16
barcode09,5,70944689,C,DEL,627,1,1,0,0.16
barcode09,5,70944690,A,DEL,631,1,1,0,0.16
barcode09,5,70944691,C,DEL,634,1,1,0,0.16
barcode09,5,70944694,C,DEL,641,5,2,3,0.78
barcode09,5,70944695,C,DEL,644,5,2,3,0.78
barcode09,5,70944696,A,DEL,649,5,2,3,0.77
barcode09,5,70944697,C,DEL,650,2,2,0,0.31
barcode09,5,70944702,A,DEL,679,1,0,1,0.15
barcode09,5,70944703,C,DEL,679,2,1,1,0.29
barcode09,5,70944704,C,DEL,676,2,1,1,0.3
barcode09,5,70944705,A,DEL,675,3,2,1,0.44
barcode09,5,70944706,C,DEL,674,62,55,7,9.2
barcode09,5,70944707,C,DEL,680,5,0,5,0.74
barcode09,5,70944711,C,DEL,682,1,0,1,0.15
barcode09,5,70944712,T,DEL,682,2,0,2,0.29
barcode09,5,70944713,T,DEL,666,2,2,0,0.3
barcode09,5,70944714,A,DEL,667,8,8,0,1.2
barcode09,5,70944715,C,DEL,666,3,3,0,0.45
barcode09,5,70944723,C,DEL,661,7,0,7,1.06
barcode09,5,70944724,T,DEL,661,13,0,13,1.97
barcode09,5,70944725,G,DEL,659,1,0,1,0.15
barcode09,5,70944728,T,DEL,655,1,0,1,0.15
barcode09,5,70944729,G,DEL,654,1,0,1,0.15
barcode09,5,70944730,C,DEL,648,4,0,4,0.62
barcode09,5,70944731,C,DEL,649,1,0,1,0.15
barcode09,5,70944734,C,DEL,654,1,1,0,0.15
barcode09,5,70944735,A,DEL,655,1,1,0,0.15
barcode09,5,70944736,T,DEL,657,7,3,4,1.07
barcode09,5,70944737,T,DEL,649,1,1,0,0.15
barcode09,5,70944738,T,DEL,651,1,1,0,0.15
barcode09,5,70944740,C,DEL,655,2,0,2,0.31
barcode09,5,70944741,T,DEL,656,15,3,12,2.29
barcode09,5,70944742,T,DEL,657,5,1,4,0.76
barcode09,5,70944743,C,DEL,659,4,1,3,0.61
barcode09,5,70944744,T,DEL,657,3,0,3,0.46
barcode09,5,70944745,G,DEL,654,1,0,1,0.15
barcode09,5,70944751,C,DEL,652,3,3,0,0.46
barcode09,5,70944753,A,DEL,651,6,1,5,0.92
barcode09,5,70944754,G,DEL,650,7,0,7,1.08
barcode09,5,70944755,T,DEL,651,12,1,11,1.84
barcode09,5,70944756,A,DEL,631,11,1,10,1.74
barcode09,5,70944757,A,DEL,630,9,1,8,1.43
barcode09,5,70944758,G,DEL,626,8,0,8,1.28
barcode09,5,70944759,T,DEL,625,29,1,28,4.64
barcode09,5,70944760,A,DEL,616,144,6,138,23.38
barcode09,5,70944761,A,DEL,616,72,0,72,11.69
barcode09,5,70944762,A,DEL,615,65,0,65,10.57
barcode09,5,70944763,A,DEL,615,23,0,23,3.74
barcode09,5,70944765,A,DEL,611,1,0,1,0.16
barcode09,5,70944766,G,DEL,609,1,0,1,0.16
barcode09,5,70944767,A,DEL,610,1,1,0,0.16
barcode09,5,70944769,T,DEL,606,26,0,26,4.29
barcode09,5,70944770,A,DEL,602,3,0,3,0.5
barcode09,5,70944771,T,DEL,601,2,0,2,0.33
barcode09,5,70944775,T,DEL,598,1,1,0,0.17
barcode09,5,70944776,T,DEL,588,1,0,1,0.17
barcode09,5,70944777,A,DEL,583,4,0,4,0.69
barcode09,5,70944778,G,DEL,580,12,6,6,2.07
barcode09,5,70944779,A,DEL,574,1,0,1,0.17
barcode09,5,70944780,T,DEL,573,21,2,19,3.66
barcode09,5,70944786,T,DEL,562,2,0,2,0.36
barcode09,5,70944789,C,DEL,551,2,1,1,0.36
barcode09,5,70944790,A,DEL,551,3,1,2,0.54
barcode09,5,70944795,C,DEL,518,1,0,1,0.19
barcode09,5,70944798,T,DEL,508,6,2,4,1.18
barcode09,5,70944804,A,DEL,480,1,1,0,0.21
barcode09,5,70944805,A,DEL,477,1,1,0,0.21
barcode09,5,70944806,T,DEL,477,1,0,1,0.21
barcode09,5,70944808,A,DEL,472,1,1,0,0.21
barcode09,5,70944809,G,DEL,472,2,1,1,0.42
barcode09,5,70944813,A,DEL,447,8,7,1,1.79
barcode09,5,70944816,A,DEL,407,6,6,0,1.47
barcode09,5,70944817,G,DEL,400,4,4,0,1.0
barcode09,5,70944819,G,DEL,387,7,7,0,1.81
barcode09,5,70944820,G,DEL,376,2,2,0,0.53
barcode09,5,70944821,A,DEL,374,2,2,0,0.53
barcode09,5,70944822,T,DEL,374,2,2,0,0.53
barcode09,5,70944825,T,DEL,358,1,0,1,0.28
barcode09,5,70944826,A,DEL,341,12,11,1,3.52
barcode09,5,70945984,C,DEL,689,12,0,12,1.74
barcode09,5,70945985,C,DEL,701,1,0,1,0.14
barcode09,5,70945986,A,DEL,738,1,0,1,0.14
barcode09,5,70945987,G,DEL,741,5,0,5,0.67
barcode09,5,70945990,T,DEL,792,11,10,1,1.39
barcode09,5,70945994,C,DEL,844,3,3,0,0.36
barcode09,5,70945995,T,DEL,846,11,7,4,1.3
barcode09,5,70945996,A,DEL,855,12,7,5,1.4
barcode09,5,70946000,A,DEL,875,7,0,7,0.8
barcode09,5,70946001,A,DEL,877,4,3,1,0.46
barcode09,5,70946002,T,DEL,879,13,3,10,1.48
barcode09,5,70946004,T,DEL,893,1,0,1,0.11
barcode09,5,70946005,A,DEL,896,14,1,13,1.56
barcode09,5,70946006,A,DEL,901,3,0,3,0.33
barcode09,5,70946008,T,DEL,908,1,1,0,0.11
barcode09,5,70946011,C,DEL,935,3,2,1,0.32
barcode09,5,70946012,C,DEL,942,2,0,2,0.21
barcode09,5,70946013,A,DEL,942,20,1,19,2.12
barcode09,5,70946014,G,DEL,943,23,3,20,2.44
barcode09,5,70946015,A,DEL,955,1,0,1,0.1
barcode09,5,70946016,C,DEL,956,4,0,4,0.42
barcode09,5,70946017,T,DEL,958,13,11,2,1.36
barcode09,5,70946018,T,DEL,958,2,0,2,0.21
barcode09,5,70946019,T,DEL,959,3,1,2,0.31
barcode09,5,70946020,A,DEL,966,5,3,2,0.52
barcode09,5,70946021,C,DEL,968,2,0,2,0.21
barcode09,5,70946022,T,DEL,968,60,12,48,6.2
barcode09,5,70946023,T,DEL,970,3,2,1,0.31
barcode09,5,70946024,T,DEL,970,2,2,0,0.21
barcode09,5,70946027,T,DEL,978,1,1,0,0.1
barcode09,5,70946028,G,DEL,1013,2,2,0,0.2
barcode09,5,70946029,T,DEL,1020,7,3,4,0.69
barcode09,5,70946032,A,DEL,1089,5,5,0,0.46
barcode09,5,70946033,C,DEL,1091,25,1,24,2.29
barcode09,5,70946035,G,DEL,1103,2,0,2,0.18
barcode09,5,70946037,A,DEL,1110,11,0,11,0.99
barcode09,5,70946038,T,DEL,1110,11,0,11,0.99
barcode09,5,70946041,A,DEL,1111,69,1,68,6.21
barcode09,5,70946042,A,DEL,1114,1,1,0,0.09
barcode09,5,70946043,A,DEL,1114,1,1,0,0.09
barcode09,5,70946045,A,DEL,1116,7,0,7,0.63
barcode09,5,70946046,A,DEL,1116,1,1,0,0.09
barcode09,5,70946047,T,DEL,1116,3,3,0,0.27
barcode09,5,70946048,A,DEL,1124,1,1,0,0.09
barcode09,5,70946050,C,DEL,1125,6,0,6,0.53
barcode09,5,70946051,T,DEL,1127,176,135,41,15.62
barcode09,5,70946052,T,DEL,1131,40,33,7,3.54
barcode09,5,70946053,T,DEL,1134,9,8,1,0.79
barcode09,5,70946054,T,DEL,1136,8,7,1,0.7
barcode09,5,70946055,T,DEL,1138,12,10,2,1.05
barcode09,5,70946056,C,DEL,1135,14,11,3,1.23
barcode09,5,70946057,T,DEL,1134,18,4,14,1.59
barcode09,5,70946058,G,DEL,1138,8,4,4,0.7
barcode09,5,70946059,T,DEL,1138,2,2,0,0.18
barcode09,5,70946060,C,DEL,1138,35,2,33,3.08
barcode09,5,70946061,T,DEL,1158,1,0,1,0.09
barcode09,5,70946062,C,DEL,1161,13,11,2,1.12
barcode09,5,70946063,C,DEL,1171,3,1,2,0.26
barcode09,5,70946064,A,DEL,1171,7,3,4,0.6
barcode09,5,70946065,G,DEL,1170,16,4,12,1.37
barcode09,5,70946066,A,DEL,1168,57,1,56,4.88
barcode09,5,70946067,T,DEL,1167,59,1,58,5.06
barcode09,5,70946068,A,DEL,1178,3,1,2,0.25
barcode09,5,70946069,A,DEL,1178,4,1,3,0.34
barcode09,5,70946070,T,DEL,1186,10,1,9,0.84
barcode09,5,70946071,T,DEL,1189,6,1,5,0.5
barcode09,5,70946072,C,DEL,1190,242,59,183,20.34
barcode09,5,70946073,C,DEL,1199,39,16,23,3.25
barcode09,5,70946074,C,DEL,1207,6,4,2,0.5
barcode09,5,70946075,C,DEL,1210,6,2,4,0.5
barcode09,5,70946076,C,DEL,1209,6,2,4,0.5
barcode09,5,70946077,A,DEL,1211,5,3,2,0.41
barcode09,5,70946078,C,DEL,1209,1,0,1,0.08
barcode09,5,70946079,C,DEL,1207,1,1,0,0.08
barcode09,5,70946080,A,DEL,1211,1,1,0,0.08
barcode09,5,70946081,C,DEL,1211,6,1,5,0.5
barcode09,5,70946082,C,DEL,1209,2,0,2,0.17
barcode09,5,70946083,T,DEL,1213,1,1,0,0.08
barcode09,5,70946084,C,DEL,1218,176,176,0,14.45
barcode09,5,70946086,C,DEL,1214,2,2,0,0.16
barcode09,5,70946087,A,DEL,1203,20,3,17,1.66
barcode09,5,70946088,T,DEL,1203,21,4,17,1.75
barcode09,5,70946089,A,DEL,1182,2,1,1,0.17
barcode09,5,70946090,T,DEL,1181,3,2,1,0.25
barcode09,5,70946091,G,DEL,1182,3,2,1,0.25
barcode09,5,70946092,T,DEL,1188,2,1,1,0.17
barcode09,5,70946093,C,DEL,1188,10,9,1,0.84
barcode09,5,70946094,C,DEL,1192,2,1,1,0.17
barcode09,5,70946095,A,DEL,1191,5,3,2,0.42
barcode09,5,70946096,G,DEL,1188,11,2,9,0.93
barcode09,5,70946097,A,DEL,1187,2,1,1,0.17
barcode09,5,70946098,T,DEL,1194,8,1,7,0.67
barcode09,5,70946099,T,DEL,1193,209,3,206,17.52
barcode09,5,70946100,C,DEL,1196,214,7,207,17.89
barcode09,5,70946101,T,DEL,1202,3,0,3,0.25
barcode09,5,70946102,C,DEL,1201,9,5,4,0.75
barcode09,5,70946103,T,DEL,1208,33,13,20,2.73
barcode09,5,70946104,T,DEL,1207,32,0,32,2.65
barcode09,5,70946105,G,DEL,1206,43,0,43,3.57
barcode09,5,70946106,A,DEL,1223,2,0,2,0.16
barcode09,5,70946107,T,DEL,1223,1,0,1,0.08
barcode09,5,70946108,G,DEL,1219,2,0,2,0.16
barcode09,5,70946109,A,DEL,1219,1,0,1,0.08
barcode09,5,70946110,T,DEL,1212,4,3,1,0.33
barcode09,5,70946111,G,DEL,1214,4,3,1,0.33
barcode09,5,70946112,C,DEL,1227,4,3,1,0.33
barcode09,5,70946113,T,DEL,1230,1,0,1,0.08
barcode09,5,70946114,G,DEL,1228,3,0,3,0.24
barcode09,5,70946115,A,DEL,1228,1,0,1,0.08
barcode09,5,70946117,G,DEL,1226,2,1,1,0.16
barcode09,5,70946118,C,DEL,1218,13,1,12,1.07
barcode09,5,70946119,T,DEL,1225,8,6,2,0.65
barcode09,5,70946120,T,DEL,1237,2,2,0,0.16
barcode09,5,70946121,T,DEL,1246,2,0,2,0.16
barcode09,5,70946122,G,DEL,1245,87,4,83,6.99
barcode09,5,70946123,G,DEL,1248,1,0,1,0.08
barcode09,5,70946124,G,DEL,1247,9,0,9,0.72
barcode09,5,70946125,A,DEL,1239,29,1,28,2.34
barcode09,5,70946127,G,DEL,1243,12,3,9,0.97
barcode09,5,70946128,T,DEL,1232,34,0,34,2.76
barcode09,5,70946132,T,DEL,1244,126,126,0,10.13
barcode09,5,70946134,A,DEL,1233,2,0,2,0.16
barcode09,5,70946136,T,DEL,1245,11,1,10,0.88
barcode09,5,70946143,G,DEL,1255,4,0,4,0.32
barcode09,5,70946144,T,DEL,1254,13,0,13,1.04
barcode09,5,70946145,A,DEL,1237,1,1,0,0.08
barcode09,5,70946150,A,DEL,1264,3,3,0,0.24
barcode09,5,70946151,G,DEL,1258,3,2,1,0.24
barcode09,5,70946154,G,DEL,1280,1,1,0,0.08
barcode09,5,70946155,C,DEL,1273,2,1,1,0.16
barcode09,5,70946156,T,DEL,1270,2,1,1,0.16
barcode09,5,70946157,A,DEL,1257,3,3,0,0.24
barcode09,5,70946158,T,DEL,1264,4,4,0,0.32
barcode09,5,70946159,C,DEL,1238,4,4,0,0.32
barcode09,5,70946160,A,DEL,1241,4,2,2,0.32
barcode09,5,70946161,T,DEL,1243,7,2,5,0.56
barcode09,5,70946162,A,DEL,1358,3,1,2,0.22
barcode09,5,70946163,C,DEL,1360,9,2,7,0.66
barcode09,5,70946164,T,DEL,1362,6,0,6,0.44
barcode09,5,70946167,C,DEL,1363,1,0,1,0.07
barcode09,5,70946168,T,DEL,1362,4,4,0,0.29
barcode09,5,70946169,A,DEL,1339,5,5,0,0.37
barcode09,5,70946170,T,DEL,1334,11,11,0,0.82
barcode09,5,70946171,T,DEL,1329,28,28,0,2.11
barcode09,5,70946172,A,DEL,1339,29,28,1,2.17
barcode09,5,70946173,T,DEL,1339,6,5,1,0.45
barcode09,5,70946174,A,DEL,1377,5,5,0,0.36
barcode09,5,70946177,G,DEL,1406,19,0,19,1.35
barcode09,5,70946178,T,DEL,1406,23,0,23,1.64
barcode09,5,70946179,A,DEL,1387,8,2,6,0.58
barcode09,5,70946180,A,DEL,1393,8,0,8,0.57
barcode09,5,70946181,G,DEL,1389,9,0,9,0.65
barcode09,5,70946182,T,DEL,1392,15,0,15,1.08
barcode09,5,70946183,A,DEL,1370,32,0,32,2.34
barcode09,5,70946189,T,DEL,1418,3,0,3,0.21
barcode09,5,70946190,C,DEL,1415,54,1,53,3.82
barcode09,5,70946192,G,DEL,1412,7,5,2,0.5
barcode09,5,70946195,T,DEL,1417,3,3,0,0.21
barcode09,5,70946196,C,DEL,1412,7,1,6,0.5
barcode09,5,70946197,T,DEL,1415,318,291,27,22.47
barcode09,5,70946198,T,DEL,1418,14,14,0,0.99
barcode09,5,70946199,T,DEL,1422,1,1,0,0.07
barcode09,5,70946200,T,DEL,1416,3,2,1,0.21
barcode09,5,70946201,C,DEL,1417,5,2,3,0.35
barcode09,5,70946202,C,DEL,1421,2,2,0,0.14
barcode09,5,70946203,T,DEL,1420,3,0,3,0.21
barcode09,5,70946204,G,DEL,1420,30,1,29,2.11
barcode09,5,70946205,A,DEL,1414,3,1,2,0.21
barcode09,5,70946206,C,DEL,1411,3,2,1,0.21
barcode09,5,70946207,A,DEL,1402,1,1,0,0.07
barcode09,5,70946209,T,DEL,1405,61,50,11,4.34
barcode09,5,70946210,T,DEL,1401,3,2,1,0.21
barcode09,5,70946211,T,DEL,1404,1,0,1,0.07
barcode09,5,70946212,T,DEL,1403,1,0,1,0.07
barcode09,5,70946214,T,DEL,1413,1,1,0,0.07
barcode09,5,70946215,T,DEL,1414,2,1,1,0.14
barcode09,5,70946216,G,DEL,1422,3,1,2,0.21
barcode09,5,70946217,T,DEL,1425,1,0,1,0.07
barcode09,5,70946218,A,DEL,1429,1,1,0,0.07
barcode09,5,70946219,G,DEL,1428,1,1,0,0.07
barcode09,5,70946220,T,DEL,1428,3,3,0,0.21
barcode09,5,70946221,T,DEL,1426,1,1,0,0.07
barcode09,5,70946222,A,DEL,1433,1,1,0,0.07
barcode09,5,70946224,G,DEL,1453,1,1,0,0.07
barcode09,5,70946225,T,DEL,1448,2,2,0,0.14
barcode09,5,70946226,G,DEL,1442,2,1,1,0.14
barcode09,5,70946227,A,DEL,1442,2,1,1,0.14
barcode09,5,70946228,C,DEL,1440,1,1,0,0.07
barcode09,5,70946229,T,DEL,1442,23,23,0,1.6
barcode09,5,70946231,T,DEL,1424,1,0,1,0.07
barcode09,5,70946232,G,DEL,1423,1,0,1,0.07
barcode09,5,70946233,T,DEL,1422,34,25,9,2.39
barcode09,5,70946236,T,DEL,1412,2,2,0,0.14
barcode09,5,70946237,G,DEL,1409,2,2,0,0.14
barcode09,5,70946238,T,DEL,1408,1,1,0,0.07
barcode09,5,70946239,A,DEL,1398,26,22,4,1.86
barcode09,5,70946240,A,DEL,1395,2,2,0,0.14
barcode09,5,70946241,A,DEL,1393,2,2,0,0.14
barcode09,5,70946242,T,DEL,1394,25,6,19,1.79
barcode09,5,70946243,T,DEL,1393,4,2,2,0.29
barcode09,5,70946244,T,DEL,1393,8,6,2,0.57
barcode09,5,70946245,A,DEL,1375,16,16,0,1.16
barcode09,5,70946246,T,DEL,1372,3,3,0,0.22
barcode09,5,70946247,A,DEL,1366,54,27,27,3.95
barcode09,5,70946248,A,DEL,1365,3,0,3,0.22
barcode09,5,70946251,T,DEL,1350,1,1,0,0.07
barcode09,5,70946252,A,DEL,1349,1,1,0,0.07
barcode09,5,70946253,C,DEL,1347,3,3,0,0.22
barcode09,5,70946255,A,DEL,1342,3,3,0,0.22
barcode09,5,70946256,C,DEL,1340,1,1,0,0.07
barcode09,5,70946257,T,DEL,1339,4,4,0,0.3
barcode09,5,70946259,G,DEL,1329,1,1,0,0.08
barcode09,5,70946260,C,DEL,1317,9,7,2,0.68
barcode09,5,70946261,T,DEL,1316,17,15,2,1.29
barcode09,5,70946262,T,DEL,1311,16,12,4,1.22
barcode09,5,70946263,C,DEL,1306,19,16,3,1.45
barcode09,5,70946264,T,DEL,1306,1,0,1,0.08
barcode09,5,70946265,C,DEL,1298,5,3,2,0.39
barcode09,5,70946266,T,DEL,1291,13,6,7,1.01
barcode09,5,70946267,C,DEL,1270,21,15,6,1.65
barcode09,5,70946268,T,DEL,1266,150,140,10,11.85
barcode09,5,70946269,T,DEL,1261,13,3,10,1.03
barcode09,5,70946270,T,DEL,1257,15,5,10,1.19
barcode09,5,70946271,A,DEL,1243,6,5,1,0.48
barcode09,5,70946272,T,DEL,1241,3,2,1,0.24
barcode09,5,70946273,A,DEL,1225,5,4,1,0.41
barcode09,5,70946274,T,DEL,1223,10,9,1,0.82
barcode09,5,70946275,T,DEL,1219,9,8,1,0.74
barcode09,5,70946276,A,DEL,1208,20,19,1,1.66
barcode09,5,70946277,C,DEL,1205,6,6,0,0.5
barcode09,5,70946279,A,DEL,1180,36,27,9,3.05
barcode09,5,70946280,A,DEL,1179,1,1,0,0.08
barcode09,5,70946286,A,DEL,1131,37,37,0,3.27
barcode09,5,70946291,T,DEL,1111,1,1,0,0.09
barcode09,5,70946292,A,DEL,1090,144,134,10,13.21
barcode09,5,70946293,A,DEL,1089,57,57,0,5.23
barcode09,5,70946294,A,DEL,1083,18,18,0,1.66
barcode09,5,70946295,A,DEL,1071,1,1,0,0.09
barcode09,5,70946299,T,DEL,1047,1,1,0,0.1
barcode09,5,70946301,C,DEL,1030,3,3,0,0.29
barcode09,5,70946302,A,DEL,1019,1,1,0,0.1
barcode09,5,70946305,T,DEL,1001,2,2,0,0.2
barcode09,5,70946306,G,DEL,986,2,2,0,0.2
barcode09,5,70946307,T,DEL,980,7,7,0,0.71
barcode09,5,70946308,C,DEL,860,6,6,0,0.7
barcode09,5,70946310,G,DEL,818,2,1,1,0.24
barcode09,5,70946315,T,DEL,647,2,2,0,0.31
barcode09,5,70951929,T,DEL,4,1,1,0,25.0
barcode09,5,70951937,A,DEL,1371,2,1,1,0.15
barcode09,5,70951938,C,DEL,1418,2,1,1,0.14
barcode09,5,70951940,G,DEL,1461,2,0,2,0.14
barcode09,5,70951942,G,DEL,1475,1,1,0,0.07
barcode09,5,70951943,T,DEL,1483,27,3,24,1.82
barcode09,5,70951946,C,DEL,1555,7,0,7,0.45
barcode09,5,70951947,A,DEL,1557,7,0,7,0.45
barcode09,5,70951948,G,DEL,1558,24,3,21,1.54
barcode09,5,70951949,A,DEL,1568,5,0,5,0.32
barcode09,5,70951950,C,DEL,1571,6,0,6,0.38
barcode09,5,70951951,A,DEL,1575,266,8,258,16.89
barcode09,5,70951952,A,DEL,1585,2,0,2,0.13
barcode09,5,70951956,C,DEL,1600,4,1,3,0.25
barcode09,5,70951957,A,DEL,1604,249,41,208,15.52
barcode09,5,70951958,A,DEL,1616,34,6,28,2.1
barcode09,5,70951959,A,DEL,1623,4,0,4,0.25
barcode09,5,70951961,A,DEL,1633,3,2,1,0.18
barcode09,5,70951962,G,DEL,1633,4,3,1,0.24
barcode09,5,70951963,A,DEL,1647,95,2,93,5.77
barcode09,5,70951964,A,DEL,1656,2,1,1,0.12
barcode09,5,70951965,G,DEL,1657,3,2,1,0.18
barcode09,5,70951966,G,DEL,1668,1,1,0,0.06
barcode09,5,70951967,A,DEL,1692,106,2,104,6.26
barcode09,5,70951969,G,DEL,1698,4,4,0,0.24
barcode09,5,70951970,G,DEL,1704,1,1,0,0.06
barcode09,5,70951971,T,DEL,1706,2,1,1,0.12
barcode09,5,70951972,G,DEL,1713,2,1,1,0.12
barcode09,5,70951973,C,DEL,1728,26,0,26,1.5
barcode09,5,70951975,C,DEL,1749,17,0,17,0.97
barcode09,5,70951976,A,DEL,1753,9,0,9,0.51
barcode09,5,70951977,C,DEL,1761,1,0,1,0.06
barcode09,5,70951978,A,DEL,1766,4,0,4,0.23
barcode09,5,70951979,T,DEL,1772,7,6,1,0.4
barcode09,5,70951980,T,DEL,1773,1,0,1,0.06
barcode09,5,70951981,C,DEL,1776,2,0,2,0.11
barcode09,5,70951982,C,DEL,1786,5,0,5,0.28
barcode09,5,70951983,T,DEL,1800,37,11,26,2.06
barcode09,5,70951984,T,DEL,1806,21,0,21,1.16
barcode09,5,70951985,A,DEL,1814,39,19,20,2.15
barcode09,5,70951986,A,DEL,1819,1,0,1,0.05
barcode09,5,70951987,A,DEL,1830,2,1,1,0.11
barcode09,5,70951988,T,DEL,1831,3,2,1,0.16
barcode09,5,70951989,T,DEL,1832,2,1,1,0.11
barcode09,5,70951990,A,DEL,1842,32,2,30,1.74
barcode09,5,70951991,A,DEL,1859,3,2,1,0.16
barcode09,5,70951992,G,DEL,1866,4,3,1,0.21
barcode09,5,70951993,G,DEL,1877,6,4,2,0.32
barcode09,5,70951994,A,DEL,1889,9,7,2,0.48
barcode09,5,70951995,G,DEL,1890,12,3,9,0.63
barcode09,5,70951996,T,DEL,1897,4,0,4,0.21
barcode09,5,70951997,A,DEL,1902,7,0,7,0.37
barcode09,5,70951998,A,DEL,1910,2,0,2,0.1
barcode09,5,70952000,T,DEL,1930,7,4,3,0.36
barcode09,5,70952001,C,DEL,1935,27,10,17,1.4
barcode09,5,70952002,T,DEL,1965,14,0,14,0.71
barcode09,5,70952003,G,DEL,2083,2,0,2,0.1
barcode09,5,70952004,C,DEL,2144,22,17,5,1.03
barcode09,5,70952005,C,DEL,2147,4,0,4,0.19
barcode09,5,70952007,G,DEL,2165,6,0,6,0.28
barcode09,5,70952008,C,DEL,2162,1,0,1,0.05
barcode09,5,70952009,A,DEL,2161,2,0,2,0.09
barcode09,5,70952010,T,DEL,2161,17,14,3,0.79
barcode09,5,70952011,T,DEL,2161,14,12,2,0.65
barcode09,5,70952012,A,DEL,2172,16,12,4,0.74
barcode09,5,70952013,T,DEL,2172,4,0,4,0.18
barcode09,5,70952014,G,DEL,2178,9,0,9,0.41
barcode09,5,70952015,A,DEL,2195,294,46,248,13.39
barcode09,5,70952016,A,DEL,2203,1,1,0,0.05
barcode09,5,70952017,A,DEL,2199,2,2,0,0.09
barcode09,5,70952018,G,DEL,2195,3,2,1,0.14
barcode09,5,70952019,T,DEL,2197,1,1,0,0.05
barcode09,5,70952020,G,DEL,2192,5,1,4,0.23
barcode09,5,70952021,A,DEL,2202,3,0,3,0.14
barcode09,5,70952023,T,DEL,2195,6,2,4,0.27
barcode09,5,70952024,C,DEL,2202,3,2,1,0.14
barcode09,5,70952025,T,DEL,2203,14,8,6,0.64
barcode09,5,70952026,T,DEL,2206,1,0,1,0.05
barcode09,5,70952027,A,DEL,2226,4,4,0,0.18
barcode09,5,70952028,C,DEL,2223,10,7,3,0.45
barcode09,5,70952029,T,DEL,2232,171,13,158,7.66
barcode09,5,70952030,T,DEL,2242,2,1,1,0.09
barcode09,5,70952031,T,DEL,2240,9,8,1,0.4
barcode09,5,70952032,T,DEL,2230,13,12,1,0.58
barcode09,5,70952033,G,DEL,2238,20,17,3,0.89
barcode09,5,70952034,T,DEL,2230,65,1,64,2.91
barcode09,5,70952035,A,DEL,2235,28,9,19,1.25
barcode09,5,70952036,A,DEL,2243,3,0,3,0.13
barcode09,5,70952040,T,DEL,2244,9,7,2,0.4
barcode09,5,70952045,G,DEL,2269,3,0,3,0.13
barcode09,5,70952047,T,DEL,2272,5,1,4,0.22
barcode09,5,70952049,T,DEL,2278,1,0,1,0.04
barcode09,5,70952050,G,DEL,2420,3,1,2,0.12
barcode09,5,70952051,T,DEL,2431,1,0,1,0.04
barcode09,5,70952052,G,DEL,2431,20,15,5,0.82
barcode09,5,70952053,G,DEL,2431,5,0,5,0.21
barcode09,5,70952054,A,DEL,2429,22,6,16,0.91
barcode09,5,70952056,A,DEL,2388,1,0,1,0.04
barcode09,5,70952057,A,DEL,2385,1,0,1,0.04
barcode09,5,70952058,C,DEL,2384,7,0,7,0.29
barcode09,5,70952059,A,DEL,2386,134,0,134,5.62
barcode09,5,70952060,A,DEL,2392,1,0,1,0.04
barcode09,5,70952061,A,DEL,2388,2,1,1,0.08
barcode09,5,70952062,T,DEL,2387,4,3,1,0.17
barcode09,5,70952063,G,DEL,2386,2,2,0,0.08
barcode09,5,70952064,T,DEL,2385,97,41,56,4.07
barcode09,5,70952065,T,DEL,2385,7,0,7,0.29
barcode09,5,70952069,G,DEL,2393,12,0,12,0.5
barcode09,5,70952070,A,DEL,2419,12,0,12,0.5
barcode09,5,70952071,A,DEL,2408,3,2,1,0.12
barcode09,5,70952072,C,DEL,2405,10,10,0,0.42
barcode09,5,70952073,A,DEL,2407,2,1,1,0.08
barcode09,5,70952074,T,DEL,2412,12,4,8,0.5
barcode09,5,70952075,T,DEL,2412,3,1,2,0.12
barcode09,5,70952076,T,DEL,2398,7,0,7,0.29
barcode09,5,70952077,A,DEL,2404,206,10,196,8.57
barcode09,5,70952078,A,DEL,2427,51,2,49,2.1
barcode09,5,70952079,A,DEL,2421,6,2,4,0.25
barcode09,5,70952080,A,DEL,2419,2,2,0,0.08
barcode09,5,70952081,A,DEL,2416,4,2,2,0.17
barcode09,5,70952082,G,DEL,2409,6,1,5,0.25
barcode09,5,70952083,T,DEL,2423,48,48,0,1.98
barcode09,5,70952084,T,DEL,2428,12,12,0,0.49
barcode09,5,70952085,C,DEL,2421,56,45,11,2.31
barcode09,5,70952086,A,DEL,2422,70,2,68,2.89
barcode09,5,70952087,G,DEL,2423,78,6,72,3.22
barcode09,5,70952088,A,DEL,2416,3,2,1,0.12
barcode09,5,70952089,T,DEL,2417,3,1,2,0.12
barcode09,5,70952090,G,DEL,2424,3,2,1,0.12
barcode09,5,70952091,T,DEL,2426,40,39,1,1.65
barcode09,5,70952092,T,DEL,2443,1,1,0,0.04
barcode09,5,70952093,A,DEL,2455,94,9,85,3.83
barcode09,5,70952094,A,DEL,2448,11,2,9,0.45
barcode09,5,70952098,G,DEL,2430,2,2,0,0.08
barcode09,5,70952099,T,DEL,2433,11,11,0,0.45
barcode09,5,70952101,G,DEL,2436,6,0,6,0.25
barcode09,5,70952102,A,DEL,2480,141,3,138,5.69
barcode09,5,70952106,G,DEL,2485,1,1,0,0.04
barcode09,5,70952107,T,DEL,2499,10,10,0,0.4
barcode09,5,70952108,T,DEL,2492,1,1,0,0.04
barcode09,5,70952109,A,DEL,2482,4,1,3,0.16
barcode09,5,70952110,A,DEL,2477,1,1,0,0.04
barcode09,5,70952111,T,DEL,2463,4,1,3,0.16
barcode09,5,70952112,G,DEL,2459,1,0,1,0.04
barcode09,5,70952113,T,DEL,2435,51,0,51,2.09
barcode09,5,70952114,A,DEL,2419,22,8,14,0.91
barcode09,5,70952115,A,DEL,2414,2,0,2,0.08
barcode09,5,70952116,A,DEL,2443,2,0,2,0.08
barcode09,5,70952117,A,DEL,2422,2,0,2,0.08
barcode09,5,70952118,C,DEL,2429,6,1,5,0.25
barcode09,5,70952119,A,DEL,2348,2,1,1,0.09
barcode09,5,70952120,A,DEL,2348,1,1,0,0.04
barcode09,5,70952121,T,DEL,2343,1,1,0,0.04
barcode09,5,70952122,C,DEL,2262,3,3,0,0.13
barcode09,5,70952123,A,DEL,2257,4,1,3,0.18
barcode09,5,70952124,A,DEL,2254,2,1,1,0.09
barcode09,5,70952125,T,DEL,2243,2,0,2,0.09
barcode09,5,70952126,A,DEL,2215,4,4,0,0.18
barcode09,5,70952127,T,DEL,2215,30,30,0,1.35
barcode09,5,70952129,A,DEL,2206,23,2,21,1.04
barcode09,5,70952130,A,DEL,2205,4,2,2,0.18
barcode09,5,70952131,A,DEL,2193,3,1,2,0.14
barcode09,5,70952132,G,DEL,2188,8,6,2,0.37
barcode09,5,70952133,A,DEL,2182,5,3,2,0.23
barcode09,5,70952134,A,DEL,2182,1,1,0,0.05
barcode09,5,70952135,T,DEL,2163,211,128,83,9.75
barcode09,5,70952136,T,DEL,2153,1,1,0,0.05
barcode09,5,70952137,T,DEL,2142,1,1,0,0.05
barcode09,5,70952138,T,DEL,2141,1,1,0,0.05
barcode09,5,70952139,G,DEL,2133,1,1,0,0.05
barcode09,5,70952142,G,DEL,2124,1,0,1,0.05
barcode09,5,70952143,C,DEL,2120,41,31,10,1.93
barcode09,5,70952144,C,DEL,2098,5,0,5,0.24
barcode09,5,70952145,A,DEL,2084,27,12,15,1.3
barcode09,5,70952146,A,DEL,2077,1,0,1,0.05
barcode09,5,70952149,C,DEL,2059,1,1,0,0.05
barcode09,5,70952150,T,DEL,2058,2,2,0,0.1
barcode09,5,70952151,A,DEL,2046,4,4,0,0.2
barcode09,5,70952152,T,DEL,2044,12,12,0,0.59
barcode09,5,70952153,T,DEL,2042,3,3,0,0.15
barcode09,5,70952154,A,DEL,1989,7,2,5,0.35
barcode09,5,70952155,G,DEL,1984,11,2,9,0.55
barcode09,5,70952158,A,DEL,1941,42,29,13,2.16
barcode09,5,70952159,A,DEL,1940,1,0,1,0.05
barcode09,5,70952164,T,DEL,1910,14,14,0,0.73
barcode09,5,70952165,T,DEL,1901,1,1,0,0.05
barcode09,5,70952166,A,DEL,1873,1,1,0,0.05
barcode09,5,70952167,A,DEL,1871,1,1,0,0.05
barcode09,5,70952168,T,DEL,1858,2,1,1,0.11
barcode09,5,70952169,C,DEL,1824,3,1,2,0.16
barcode09,5,70952170,T,DEL,1817,9,0,9,0.5
barcode09,5,70952171,A,DEL,1782,2,0,2,0.11
barcode09,5,70952172,C,DEL,1752,1,1,0,0.06
barcode09,5,70952174,T,DEL,1722,8,0,8,0.46
barcode09,5,70952175,C,DEL,1707,23,17,6,1.35
barcode09,5,70952176,C,DEL,1698,1,1,0,0.06
barcode09,5,70952177,C,DEL,1690,2,2,0,0.12
barcode09,5,70952178,T,DEL,1655,9,3,6,0.54
barcode09,5,70952179,A,DEL,1610,5,5,0,0.31
barcode09,5,70952182,A,DEL,1528,8,8,0,0.52
barcode09,5,70952183,G,DEL,1521,7,7,0,0.46
barcode09,5,70952184,A,DEL,1507,5,0,5,0.33
barcode09,5,70952186,T,DEL,1495,2,2,0,0.13
barcode09,5,70952187,T,DEL,1488,2,2,0,0.13
barcode09,5,70952188,C,DEL,1475,4,3,1,0.27
barcode09,5,70952189,T,DEL,1452,2,1,1,0.14
barcode09,5,70952190,C,DEL,1431,5,1,4,0.35
barcode09,5,70952191,A,DEL,1419,1,1,0,0.07
barcode09,5,70952193,A,DEL,1368,5,5,0,0.37
barcode09,5,70952194,C,DEL,1258,2,2,0,0.16
barcode09,5,70952195,T,DEL,1241,12,9,3,0.97
barcode09,5,70952200,T,DEL,1097,1,1,0,0.09
barcode09,5,70952201,G,DEL,1062,1,1,0,0.09
barcode09,5,70952202,G,DEL,1060,1,1,0,0.09
barcode09,5,70952203,T,DEL,1059,4,4,0,0.38
barcode15,5,70924785,A,DEL,1,1,1,0,100.0
barcode15,5,70924860,A,DEL,269,10,0,10,3.72
barcode15,5,70924865,A,DEL,496,12,0,12,2.42
barcode15,5,70924868,C,DEL,516,3,0,3,0.58
barcode15,5,70924869,A,DEL,526,3,0,3,0.57
barcode15,5,70924870,A,DEL,528,2,0,2,0.38
barcode15,5,70924871,A,DEL,529,6,0,6,1.13
barcode15,5,70924872,C,DEL,529,14,0,14,2.65
barcode15,5,70924873,A,DEL,530,174,2,172,32.83
barcode15,5,70924874,A,DEL,534,68,1,67,12.73
barcode15,5,70924875,A,DEL,539,25,0,25,4.64
barcode15,5,70924876,A,DEL,541,5,0,5,0.92
barcode15,5,70924877,A,DEL,542,4,0,4,0.74
barcode15,5,70924878,A,DEL,542,2,0,2,0.37
barcode15,5,70924879,A,DEL,549,1,0,1,0.18
barcode15,5,70924880,A,DEL,552,1,0,1,0.18
barcode15,5,70924881,A,DEL,552,1,0,1,0.18
barcode15,5,70924882,A,DEL,552,1,0,1,0.18
barcode15,5,70924883,G,DEL,552,3,0,3,0.54
barcode15,5,70924884,G,DEL,560,1,0,1,0.18
barcode15,5,70924885,A,DEL,563,27,0,27,4.8
barcode15,5,70924890,A,DEL,572,16,0,16,2.8
barcode15,5,70924891,A,DEL,573,3,0,3,0.52
barcode15,5,70924892,A,DEL,576,2,2,0,0.35
barcode15,5,70924893,T,DEL,576,2,2,0,0.35
barcode15,5,70924895,T,DEL,590,1,0,1,0.17
barcode15,5,70924896,A,DEL,599,5,0,5,0.83
barcode15,5,70924897,A,DEL,612,1,0,1,0.16
barcode15,5,70924898,C,DEL,623,2,0,2,0.32
barcode15,5,70924904,G,DEL,706,1,0,1,0.14
barcode15,5,70924905,A,DEL,709,19,0,19,2.68
barcode15,5,70924910,A,DEL,736,13,0,13,1.77
barcode15,5,70924911,A,DEL,740,2,0,2,0.27
barcode15,5,70924915,A,DEL,750,1,1,0,0.13
barcode15,5,70924916,T,DEL,751,5,5,0,0.67
barcode15,5,70924917,T,DEL,753,1,1,0,0.13
barcode15,5,70924918,G,DEL,758,7,5,2,0.92
barcode15,5,70924919,A,DEL,779,6,4,2,0.77
barcode15,5,70924920,G,DEL,783,1,0,1,0.13
barcode15,5,70924922,G,DEL,794,2,0,2,0.25
barcode15,5,70924923,A,DEL,797,3,3,0,0.38
barcode15,5,70924924,A,DEL,801,1,1,0,0.12
barcode15,5,70924927,G,DEL,806,2,0,2,0.25
barcode15,5,70924928,A,DEL,808,56,6,50,6.93
barcode15,5,70924929,A,DEL,810,3,1,2,0.37
barcode15,5,70924930,A,DEL,811,3,1,2,0.37
barcode15,5,70924931,A,DEL,814,4,3,1,0.49
barcode15,5,70924932,A,DEL,817,8,5,3,0.98
barcode15,5,70924933,T,DEL,817,10,6,4,1.22
barcode15,5,70924936,A,DEL,832,1,0,1,0.12
barcode15,5,70924937,C,DEL,838,2,0,2,0.24
barcode15,5,70924941,C,DEL,859,7,1,6,0.81
barcode15,5,70924942,C,DEL,863,5,0,5,0.58
barcode15,5,70924944,C,DEL,877,2,0,2,0.23
barcode15,5,70924945,A,DEL,873,20,2,18,2.29
barcode15,5,70924946,A,DEL,874,1,0,1,0.11
barcode15,5,70924947,A,DEL,878,2,0,2,0.23
barcode15,5,70924948,T,DEL,878,3,0,3,0.34
barcode15,5,70924949,G,DEL,889,2,0,2,0.22
barcode15,5,70924950,T,DEL,891,4,3,1,0.45
barcode15,5,70924951,G,DEL,896,235,13,222,26.23
barcode15,5,70924954,A,DEL,904,1,0,1,0.11
barcode15,5,70924955,G,DEL,903,4,2,2,0.44
barcode15,5,70924962,A,DEL,923,3,0,3,0.33
barcode15,5,70924964,C,DEL,925,1,1,0,0.11
barcode15,5,70924965,C,DEL,926,3,3,0,0.32
barcode15,5,70924966,A,DEL,930,3,3,0,0.32
barcode15,5,70924967,C,DEL,930,5,0,5,0.54
barcode15,5,70924968,T,DEL,933,26,0,26,2.79
barcode15,5,70924969,C,DEL,937,9,0,9,0.96
barcode15,5,70924970,G,DEL,937,7,0,7,0.75
barcode15,5,70924971,T,DEL,937,23,0,23,2.45
barcode15,5,70924972,A,DEL,944,14,4,10,1.48
barcode15,5,70924973,G,DEL,945,14,3,11,1.48
barcode15,5,70924974,A,DEL,955,7,0,7,0.73
barcode15,5,70924979,G,DEL,959,1,1,0,0.1
barcode15,5,70924980,T,DEL,956,2,2,0,0.21
barcode15,5,70924981,G,DEL,954,14,9,5,1.47
barcode15,5,70924982,A,DEL,955,2,0,2,0.21
barcode15,5,70924983,G,DEL,959,7,0,7,0.73
barcode15,5,70924984,A,DEL,959,8,3,5,0.83
barcode15,5,70924987,T,DEL,960,3,3,0,0.31
barcode15,5,70924988,T,DEL,960,4,4,0,0.42
barcode15,5,70924989,A,DEL,963,5,5,0,0.52
barcode15,5,70924990,C,DEL,961,6,5,1,0.62
barcode15,5,70924991,T,DEL,961,2,1,1,0.21
barcode15,5,70924992,A,DEL,969,2,2,0,0.21
barcode15,5,70924993,C,DEL,969,3,3,0,0.31
barcode15,5,70924994,A,DEL,975,4,3,1,0.41
barcode15,5,70924995,A,DEL,989,1,1,0,0.1
barcode15,5,70924996,G,DEL,989,3,1,2,0.3
barcode15,5,70924997,C,DEL,986,2,1,1,0.2
barcode15,5,70925000,T,DEL,984,50,0,50,5.08
barcode15,5,70925001,C,DEL,979,58,1,57,5.92
barcode15,5,70925002,C,DEL,982,12,0,12,1.22
barcode15,5,70925003,T,DEL,984,6,0,6,0.61
barcode15,5,70925004,C,DEL,993,91,64,27,9.16
barcode15,5,70925012,C,DEL,1009,1,1,0,0.1
barcode15,5,70925014,G,DEL,1009,1,0,1,0.1
barcode15,5,70925017,C,DEL,1012,4,4,0,0.4
barcode15,5,70925020,T,DEL,1013,57,2,55,5.63
barcode15,5,70925022,C,DEL,1023,8,2,6,0.78
barcode15,5,70925023,C,DEL,1022,1,0,1,0.1
barcode15,5,70925024,G,DEL,1022,1,0,1,0.1
barcode15,5,70925025,C,DEL,1025,2,0,2,0.2
barcode15,5,70925026,T,DEL,1027,1,0,1,0.1
barcode15,5,70925027,C,DEL,1033,138,129,9,13.36
barcode15,5,70925029,C,DEL,1035,3,2,1,0.29
barcode15,5,70925030,A,DEL,1035,6,2,4,0.58
barcode15,5,70925031,G,DEL,1037,5,0,5,0.48
barcode15,5,70925032,A,DEL,1038,3,0,3,0.29
barcode15,5,70925035,C,DEL,1037,151,100,51,14.56
barcode15,5,70925036,C,DEL,1033,2,1,1,0.19
barcode15,5,70925037,C,DEL,1034,1,0,1,0.1
barcode15,5,70925038,C,DEL,1034,19,16,3,1.84
barcode15,5,70925039,G,DEL,1034,49,27,22,4.74
barcode15,5,70925046,G,DEL,1039,7,6,1,0.67
barcode15,5,70925048,A,DEL,1039,96,2,94,9.24
barcode15,5,70925049,A,DEL,1036,1,0,1,0.1
barcode15,5,70925054,T,DEL,1031,2,0,2,0.19
barcode15,5,70925055,C,DEL,1030,3,0,3,0.29
barcode15,5,70925057,C,DEL,1028,4,1,3,0.39
barcode15,5,70925058,T,DEL,1029,1,1,0,0.1
barcode15,5,70925059,C,DEL,1029,2,1,1,0.19
barcode15,5,70925060,T,DEL,1029,40,22,18,3.89
barcode15,5,70925061,T,DEL,1027,4,1,3,0.39
barcode15,5,70925062,A,DEL,1027,23,4,19,2.24
barcode15,5,70925064,G,DEL,1024,1,0,1,0.1
barcode15,5,70925065,A,DEL,1026,24,15,9,2.34
barcode15,5,70925066,A,DEL,1025,9,9,0,0.88
barcode15,5,70925067,G,DEL,1025,27,14,13,2.63
barcode15,5,70925068,G,DEL,1021,2,2,0,0.2
barcode15,5,70925071,C,DEL,1000,3,2,1,0.3
barcode15,5,70925072,G,DEL,1000,33,27,6,3.3
barcode15,5,70925073,G,DEL,989,3,2,1,0.3
barcode15,5,70925074,G,DEL,985,3,3,0,0.3
barcode15,5,70925075,G,DEL,972,32,32,0,3.29
barcode15,5,70925076,C,DEL,971,61,57,4,6.28
barcode15,5,70925077,C,DEL,975,35,33,2,3.59
barcode15,5,70925078,C,DEL,974,33,32,1,3.39
barcode15,5,70925079,C,DEL,977,15,12,3,1.54
barcode15,5,70925080,A,DEL,977,16,14,2,1.64
barcode15,5,70925081,C,DEL,986,1,0,1,0.1
barcode15,5,70925082,G,DEL,985,2,2,0,0.2
barcode15,5,70925083,C,DEL,987,1,0,1,0.1
barcode15,5,70925084,T,DEL,987,2,1,1,0.2
barcode15,5,70925085,G,DEL,991,8,8,0,0.81
barcode15,5,70925086,C,DEL,988,5,5,0,0.51
barcode15,5,70925087,G,DEL,986,1,1,0,0.1
barcode15,5,70925088,C,DEL,988,6,0,6,0.61
barcode15,5,70925090,C,DEL,986,17,15,2,1.72
barcode15,5,70925092,C,DEL,976,2,2,0,0.2
barcode15,5,70925093,G,DEL,988,2,2,0,0.2
barcode15,5,70925095,G,DEL,984,10,0,10,1.02
barcode15,5,70925097,G,DEL,977,1,1,0,0.1
barcode15,5,70925098,T,DEL,979,5,4,1,0.51
barcode15,5,70925099,T,DEL,972,1,1,0,0.1
barcode15,5,70925100,T,DEL,967,3,3,0,0.31
barcode15,5,70925101,G,DEL,970,2,2,0,0.21
barcode15,5,70925102,C,DEL,969,2,2,0,0.21
barcode15,5,70925103,T,DEL,967,3,2,1,0.31
barcode15,5,70925104,A,DEL,974,2,2,0,0.21
barcode15,5,70925106,G,DEL,970,1,0,1,0.1
barcode15,5,70925108,C,DEL,964,2,0,2,0.21
barcode15,5,70925109,G,DEL,959,8,1,7,0.83
barcode15,5,70925110,A,DEL,963,8,1,7,0.83
barcode15,5,70925113,A,DEL,961,1,1,0,0.1
barcode15,5,70925114,G,DEL,959,12,0,12,1.25
barcode15,5,70925115,C,DEL,962,13,0,13,1.35
barcode15,5,70925117,G,DEL,960,3,2,1,0.31
barcode15,5,70925118,C,DEL,959,3,2,1,0.31
barcode15,5,70925119,G,DEL,958,7,4,3,0.73
barcode15,5,70925120,G,DEL,952,1,0,1,0.11
barcode15,5,70925124,C,DEL,916,2,0,2,0.22
barcode15,5,70925125,A,DEL,909,10,9,1,1.1
barcode15,5,70925126,G,DEL,909,10,9,1,1.1
barcode15,5,70925127,T,DEL,908,9,9,0,0.99
barcode15,5,70925129,G,DEL,904,1,0,1,0.11
barcode15,5,70925130,T,DEL,903,1,0,1,0.11
barcode15,5,70925131,G,DEL,901,5,5,0,0.55
barcode15,5,70925132,G,DEL,901,5,5,0,0.55
barcode15,5,70925133,C,DEL,897,5,5,0,0.56
barcode15,5,70925134,G,DEL,894,2,0,2,0.22
barcode15,5,70925135,G,DEL,890,1,0,1,0.11
barcode15,5,70925136,C,DEL,883,1,0,1,0.11
barcode15,5,70925138,T,DEL,875,1,0,1,0.11
barcode15,5,70925139,C,DEL,871,22,22,0,2.53
barcode15,5,70925141,C,DEL,868,1,0,1,0.12
barcode15,5,70925142,G,DEL,865,9,5,4,1.04
barcode15,5,70925143,G,DEL,865,4,0,4,0.46
barcode15,5,70925144,A,DEL,858,1,0,1,0.12
barcode15,5,70925145,G,DEL,853,11,1,10,1.29
barcode15,5,70925146,C,DEL,851,2,2,0,0.24
barcode15,5,70925147,A,DEL,852,14,14,0,1.64
barcode15,5,70925148,G,DEL,852,10,10,0,1.17
barcode15,5,70925149,G,DEL,851,9,9,0,1.06
barcode15,5,70925150,A,DEL,848,9,9,0,1.06
barcode15,5,70925151,G,DEL,846,15,15,0,1.77
barcode15,5,70925152,G,DEL,844,22,22,0,2.61
barcode15,5,70925153,A,DEL,842,22,22,0,2.61
barcode15,5,70925154,T,DEL,842,43,41,2,5.11
barcode15,5,70925155,T,DEL,839,2,0,2,0.24
barcode15,5,70925156,C,DEL,839,3,1,2,0.36
barcode15,5,70925158,G,DEL,833,6,0,6,0.72
barcode15,5,70925159,T,DEL,830,8,2,6,0.96
barcode15,5,70925160,G,DEL,798,1,1,0,0.13
barcode15,5,70925161,C,DEL,786,2,2,0,0.25
barcode15,5,70925162,T,DEL,786,3,1,2,0.38
barcode15,5,70925163,G,DEL,786,1,1,0,0.13
barcode15,5,70925164,T,DEL,782,9,7,2,1.15
barcode15,5,70925166,C,DEL,776,3,2,1,0.39
barcode15,5,70925167,C,DEL,775,4,1,3,0.52
barcode15,5,70925168,G,DEL,774,15,3,12,1.94
barcode15,5,70925169,G,DEL,770,2,2,0,0.26
barcode15,5,70925170,C,DEL,761,2,2,0,0.26
barcode15,5,70925171,G,DEL,746,4,4,0,0.54
barcode15,5,70925172,C,DEL,740,1,1,0,0.14
barcode15,5,70925173,G,DEL,736,1,1,0,0.14
barcode15,5,70925175,C,DEL,731,1,1,0,0.14
barcode15,5,70925176,A,DEL,726,2,2,0,0.28
barcode15,5,70925177,C,DEL,724,1,1,0,0.14
barcode15,5,70925178,A,DEL,723,4,4,0,0.55
barcode15,5,70925179,G,DEL,723,1,1,0,0.14
barcode15,5,70925181,C,DEL,718,7,7,0,0.97
barcode15,5,70925184,G,DEL,705,1,0,1,0.14
barcode15,5,70925187,G,DEL,694,1,1,0,0.14
barcode15,5,70925188,A,DEL,691,1,1,0,0.14
barcode15,5,70925191,T,DEL,674,3,3,0,0.45
barcode15,5,70925193,G,DEL,664,2,1,1,0.3
barcode15,5,70925194,C,DEL,664,2,1,1,0.3
barcode15,5,70925195,A,DEL,656,2,1,1,0.3
barcode15,5,70925197,C,DEL,649,4,4,0,0.62
barcode15,5,70925202,G,DEL,622,2,2,0,0.32
barcode15,5,70925205,G,DEL,604,1,1,0,0.17
barcode15,5,70925207,C,DEL,568,9,0,9,1.58
barcode15,5,70925209,C,DEL,553,2,2,0,0.36
barcode15,5,70925211,C,DEL,511,1,0,1,0.2
barcode15,5,70925212,T,DEL,497,1,0,1,0.2
barcode15,5,70925213,A,DEL,249,2,2,0,0.8
barcode15,5,70938766,T,DEL,327,3,1,2,0.92
barcode15,5,70938767,C,DEL,350,11,1,10,3.14
barcode15,5,70938768,T,DEL,403,27,3,24,6.7
barcode15,5,70938770,G,DEL,417,1,0,1,0.24
barcode15,5,70938772,T,DEL,432,10,0,10,2.31
barcode15,5,70938775,T,DEL,451,3,0,3,0.67
barcode15,5,70938776,A,DEL,465,1,0,1,0.22
barcode15,5,70938781,A,DEL,485,10,10,0,2.06
barcode15,5,70938782,C,DEL,487,1,0,1,0.21
barcode15,5,70938783,A,DEL,488,4,0,4,0.82
barcode15,5,70938784,T,DEL,488,29,12,17,5.94
barcode15,5,70938785,T,DEL,492,3,0,3,0.61
barcode15,5,70938787,T,DEL,495,2,1,1,0.4
barcode15,5,70938788,C,DEL,508,8,4,4,1.57
barcode15,5,70938790,G,DEL,509,9,0,9,1.77
barcode15,5,70938794,A,DEL,516,23,1,22,4.46
barcode15,5,70938795,A,DEL,542,1,1,0,0.18
barcode15,5,70938796,A,DEL,556,1,1,0,0.18
barcode15,5,70938797,C,DEL,559,1,1,0,0.18
barcode15,5,70938798,C,DEL,572,1,1,0,0.17
barcode15,5,70938799,T,DEL,572,2,0,2,0.35
barcode15,5,70938801,T,DEL,580,2,0,2,0.34
barcode15,5,70938802,C,DEL,598,1,1,0,0.17
barcode15,5,70938804,G,DEL,603,8,0,8,1.33
barcode15,5,70938805,A,DEL,609,20,0,20,3.28
barcode15,5,70938808,A,DEL,658,3,0,3,0.46
barcode15,5,70938809,T,DEL,662,1,0,1,0.15
barcode15,5,70938810,G,DEL,680,2,0,2,0.29
barcode15,5,70938813,T,DEL,718,1,0,1,0.14
barcode15,5,70938814,T,DEL,720,2,0,2,0.28
barcode15,5,70938815,G,DEL,731,2,0,2,0.27
barcode15,5,70938816,T,DEL,734,83,49,34,11.31
barcode15,5,70938817,T,DEL,737,29,27,2,3.93
barcode15,5,70938818,T,DEL,741,1,1,0,0.13
barcode15,5,70938819,T,DEL,741,2,2,0,0.27
barcode15,5,70938820,T,DEL,741,2,2,0,0.27
barcode15,5,70938821,A,DEL,743,4,4,0,0.54
barcode15,5,70938822,T,DEL,746,8,4,4,1.07
barcode15,5,70938823,T,DEL,757,2,1,1,0.26
barcode15,5,70938824,T,DEL,758,1,1,0,0.13
barcode15,5,70938825,C,DEL,771,1,1,0,0.13
barcode15,5,70938826,T,DEL,776,22,22,0,2.84
barcode15,5,70938827,T,DEL,778,1,0,1,0.13
barcode15,5,70938828,A,DEL,787,3,2,1,0.38
barcode15,5,70938829,C,DEL,788,21,3,18,2.66
barcode15,5,70938831,C,DEL,791,2,2,0,0.25
barcode15,5,70938832,T,DEL,792,21,20,1,2.65
barcode15,5,70938833,T,DEL,795,1,1,0,0.13
barcode15,5,70938835,C,DEL,799,1,1,0,0.13
barcode15,5,70938837,A,DEL,807,3,3,0,0.37
barcode15,5,70938838,G,DEL,810,1,1,0,0.12
barcode15,5,70938847,T,DEL,810,6,5,1,0.74
barcode15,5,70938848,T,DEL,810,4,4,0,0.49
barcode15,5,70938849,C,DEL,827,4,4,0,0.48
barcode15,5,70938850,T,DEL,827,3,3,0,0.36
barcode15,5,70938851,G,DEL,828,4,0,4,0.48
barcode15,5,70938852,A,DEL,828,1,0,1,0.12
barcode15,5,70938854,A,DEL,826,2,2,0,0.24
barcode15,5,70938855,T,DEL,827,11,9,2,1.33
barcode15,5,70938858,G,DEL,838,35,1,34,4.18
barcode15,5,70938861,A,DEL,837,1,0,1,0.12
barcode15,5,70938862,T,DEL,836,1,1,0,0.12
barcode15,5,70938863,G,DEL,832,1,1,0,0.12
barcode15,5,70938864,A,DEL,835,3,0,3,0.36
barcode15,5,70938865,T,DEL,824,2,0,2,0.24
barcode15,5,70938866,A,DEL,847,7,7,0,0.83
barcode15,5,70938868,A,DEL,844,1,1,0,0.12
barcode15,5,70938869,G,DEL,844,6,1,5,0.71
barcode15,5,70938872,C,DEL,841,3,2,1,0.36
barcode15,5,70938875,A,DEL,824,1,0,1,0.12
barcode15,5,70938876,T,DEL,823,2,0,2,0.24
barcode15,5,70938877,A,DEL,805,29,22,7,3.6
barcode15,5,70938883,A,DEL,796,1,1,0,0.13
barcode15,5,70938884,T,DEL,793,1,1,0,0.13
barcode15,5,70938885,A,DEL,793,2,2,0,0.25
barcode15,5,70938886,T,DEL,793,2,2,0,0.25
barcode15,5,70938887,G,DEL,786,3,3,0,0.38
barcode15,5,70938888,A,DEL,785,1,0,1,0.13
barcode15,5,70938889,T,DEL,783,1,0,1,0.13
barcode15,5,70938890,A,DEL,776,7,5,2,0.9
barcode15,5,70938893,G,DEL,772,1,1,0,0.13
barcode15,5,70938894,C,DEL,769,1,1,0,0.13
barcode15,5,70938895,T,DEL,762,1,1,0,0.13
barcode15,5,70938896,G,DEL,761,1,1,0,0.13
barcode15,5,70938897,T,DEL,757,1,1,0,0.13
barcode15,5,70938898,G,DEL,734,1,0,1,0.14
barcode15,5,70938899,G,DEL,719,1,0,1,0.14
barcode15,5,70938900,C,DEL,716,5,0,5,0.7
barcode15,5,70938901,T,DEL,713,6,6,0,0.84
barcode15,5,70938904,A,DEL,690,1,1,0,0.14
barcode15,5,70938905,T,DEL,690,3,3,0,0.43
barcode15,5,70938908,A,DEL,685,10,1,9,1.46
barcode15,5,70938910,G,DEL,669,2,2,0,0.3
barcode15,5,70938912,T,DEL,663,4,1,3,0.6
barcode15,5,70938913,A,DEL,656,1,1,0,0.15
barcode15,5,70938916,A,DEL,642,2,0,2,0.31
barcode15,5,70938918,A,DEL,631,1,1,0,0.16
barcode15,5,70938919,T,DEL,628,17,17,0,2.71
barcode15,5,70938920,G,DEL,625,17,17,0,2.72
barcode15,5,70938921,C,DEL,624,17,17,0,2.72
barcode15,5,70938922,T,DEL,623,18,18,0,2.89
barcode15,5,70938923,T,DEL,617,1,1,0,0.16
barcode15,5,70938924,G,DEL,613,5,5,0,0.82
barcode15,5,70938925,C,DEL,602,2,1,1,0.33
barcode15,5,70938926,T,DEL,601,6,5,1,1.0
barcode15,5,70938927,T,DEL,584,3,3,0,0.51
barcode15,5,70938928,A,DEL,582,2,2,0,0.34
barcode15,5,70938929,G,DEL,581,1,1,0,0.17
barcode15,5,70938931,C,DEL,563,5,5,0,0.89
barcode15,5,70938932,G,DEL,562,3,3,0,0.53
barcode15,5,70938933,T,DEL,562,32,32,0,5.69
barcode15,5,70938935,T,DEL,552,1,1,0,0.18
barcode15,5,70938936,T,DEL,549,3,3,0,0.55
barcode15,5,70938937,C,DEL,547,3,3,0,0.55
barcode15,5,70938938,T,DEL,547,2,2,0,0.37
barcode15,5,70938939,T,DEL,546,1,1,0,0.18
barcode15,5,70938940,A,DEL,544,1,1,0,0.18
barcode15,5,70938941,T,DEL,544,56,56,0,10.29
barcode15,5,70938944,T,DEL,528,3,3,0,0.57
barcode15,5,70938945,C,DEL,524,5,5,0,0.95
barcode15,5,70938946,T,DEL,520,1,1,0,0.19
barcode15,5,70940084,T,DEL,1,1,1,0,100.0
barcode15,5,70941351,A,DEL,7,1,0,1,14.29
barcode15,5,70941358,A,DEL,207,1,0,1,0.48
barcode15,5,70941368,T,DEL,296,66,2,64,22.3
barcode15,5,70941369,T,DEL,304,3,0,3,0.99
barcode15,5,70941376,C,DEL,323,1,0,1,0.31
barcode15,5,70941377,C,DEL,328,4,0,4,1.22
barcode15,5,70941378,T,DEL,332,15,0,15,4.52
barcode15,5,70941380,T,DEL,345,33,7,26,9.57
barcode15,5,70941382,T,DEL,356,1,0,1,0.28
barcode15,5,70941383,T,DEL,359,1,0,1,0.28
barcode15,5,70941384,C,DEL,365,41,0,41,11.23
barcode15,5,70941386,T,DEL,378,19,0,19,5.03
barcode15,5,70941390,A,DEL,401,1,1,0,0.25
barcode15,5,70941391,T,DEL,401,1,0,1,0.25
barcode15,5,70941392,G,DEL,407,2,1,1,0.49
barcode15,5,70941393,C,DEL,415,1,1,0,0.24
barcode15,5,70941395,C,DEL,443,1,1,0,0.23
barcode15,5,70941396,T,DEL,446,15,0,15,3.36
barcode15,5,70941397,A,DEL,454,28,0,28,6.17
barcode15,5,70941400,G,DEL,456,2,2,0,0.44
barcode15,5,70941401,A,DEL,462,3,3,0,0.65
barcode15,5,70941404,G,DEL,469,1,0,1,0.21
barcode15,5,70941407,G,DEL,495,1,1,0,0.2
barcode15,5,70941408,A,DEL,499,3,0,3,0.6
barcode15,5,70941411,T,DEL,510,7,6,1,1.37
barcode15,5,70941412,T,DEL,511,1,1,0,0.2
barcode15,5,70941413,T,DEL,513,9,9,0,1.75
barcode15,5,70941414,G,DEL,522,16,16,0,3.07
barcode15,5,70941415,T,DEL,526,3,3,0,0.57
barcode15,5,70941416,G,DEL,527,3,2,1,0.57
barcode15,5,70941417,A,DEL,528,34,7,27,6.44
barcode15,5,70941421,T,DEL,555,13,13,0,2.34
barcode15,5,70941423,C,DEL,579,10,9,1,1.73
barcode15,5,70941424,G,DEL,604,16,0,16,2.65
barcode15,5,70941425,G,DEL,603,1,0,1,0.17
barcode15,5,70941426,G,DEL,598,2,0,2,0.33
barcode15,5,70941427,T,DEL,601,4,0,4,0.67
barcode15,5,70941428,A,DEL,600,9,0,9,1.5
barcode15,5,70941431,C,DEL,604,9,8,1,1.49
barcode15,5,70941433,A,DEL,605,54,8,46,8.93
barcode15,5,70941436,A,DEL,605,1,0,1,0.17
barcode15,5,70941437,A,DEL,606,1,0,1,0.17
barcode15,5,70941438,C,DEL,606,1,0,1,0.17
barcode15,5,70941439,C,DEL,607,3,0,3,0.49
barcode15,5,70941440,A,DEL,608,2,0,2,0.33
barcode15,5,70941443,C,DEL,611,2,1,1,0.33
barcode15,5,70941445,T,DEL,611,2,2,0,0.33
barcode15,5,70941446,A,DEL,607,42,11,31,6.92
barcode15,5,70941447,A,DEL,608,2,1,1,0.33
barcode15,5,70941448,A,DEL,607,1,1,0,0.16
barcode15,5,70941449,A,DEL,602,1,1,0,0.17
barcode15,5,70941450,G,DEL,600,2,1,1,0.33
barcode15,5,70941451,A,DEL,598,6,2,4,1.0
barcode15,5,70941457,T,DEL,601,1,0,1,0.17
barcode15,5,70941458,G,DEL,605,1,1,0,0.17
barcode15,5,70941459,C,DEL,606,1,1,0,0.17
barcode15,5,70941461,A,DEL,606,29,21,8,4.79
barcode15,5,70941462,A,DEL,611,21,16,5,3.44
barcode15,5,70941463,G,DEL,608,21,16,5,3.45
barcode15,5,70941464,A,DEL,608,14,13,1,2.3
barcode15,5,70941465,A,DEL,610,27,27,0,4.43
barcode15,5,70941466,G,DEL,606,40,40,0,6.6
barcode15,5,70941467,A,DEL,604,13,10,3,2.15
barcode15,5,70941468,A,DEL,603,3,0,3,0.5
barcode15,5,70941469,T,DEL,602,2,0,2,0.33
barcode15,5,70941470,A,DEL,599,31,10,21,5.18
barcode15,5,70941471,A,DEL,601,5,0,5,0.83
barcode15,5,70941474,G,DEL,600,1,1,0,0.17
barcode15,5,70941475,C,DEL,600,3,2,1,0.5
barcode15,5,70941476,C,DEL,602,2,0,2,0.33
barcode15,5,70941477,A,DEL,600,88,20,68,14.67
barcode15,5,70941478,A,DEL,599,9,0,9,1.5
barcode15,5,70941479,A,DEL,594,2,1,1,0.34
barcode15,5,70941480,A,DEL,591,4,1,3,0.68
barcode15,5,70941481,G,DEL,590,3,1,2,0.51
barcode15,5,70941482,A,DEL,588,22,0,22,3.74
barcode15,5,70941483,A,DEL,588,5,4,1,0.85
barcode15,5,70941484,G,DEL,583,6,5,1,1.03
barcode15,5,70941485,A,DEL,583,34,30,4,5.83
barcode15,5,70941486,A,DEL,582,2,1,1,0.34
barcode15,5,70941487,T,DEL,582,1,0,1,0.17
barcode15,5,70941488,A,DEL,580,1,0,1,0.17
barcode15,5,70941489,C,DEL,579,3,3,0,0.52
barcode15,5,70941493,A,DEL,573,1,1,0,0.17
barcode15,5,70941495,C,DEL,556,12,0,12,2.16
barcode15,5,70941496,T,DEL,555,26,20,6,4.68
barcode15,5,70941500,T,DEL,531,38,38,0,7.16
barcode15,5,70941502,A,DEL,502,7,6,1,1.39
barcode15,5,70941503,C,DEL,499,1,0,1,0.2
barcode15,5,70941513,T,DEL,448,6,6,0,1.34
barcode15,5,70941516,T,DEL,445,3,2,1,0.67
barcode15,5,70941517,A,DEL,442,9,8,1,2.04
barcode15,5,70941523,T,DEL,440,31,31,0,7.05
barcode15,5,70941524,T,DEL,438,1,1,0,0.23
barcode15,5,70941525,G,DEL,430,8,8,0,1.86
barcode15,5,70941527,G,DEL,420,3,3,0,0.71
barcode15,5,70941529,T,DEL,413,8,8,0,1.94
barcode15,5,70941531,T,DEL,410,1,0,1,0.24
barcode15,5,70941532,A,DEL,407,1,0,1,0.25
barcode15,5,70941535,T,DEL,403,30,30,0,7.44
barcode15,5,70941537,C,DEL,391,1,1,0,0.26
barcode15,5,70941538,A,DEL,386,1,0,1,0.26
barcode15,5,70942315,A,DEL,47,1,1,0,2.13
barcode15,5,70942323,T,DEL,78,1,1,0,1.28
barcode15,5,70942324,G,DEL,83,1,1,0,1.2
barcode15,5,70942333,T,DEL,95,8,1,7,8.42
barcode15,5,70942334,A,DEL,96,1,1,0,1.04
barcode15,5,70942340,C,DEL,97,1,0,1,1.03
barcode15,5,70942341,T,DEL,98,9,8,1,9.18
barcode15,5,70942344,G,DEL,147,5,0,5,3.4
barcode15,5,70942350,T,DEL,150,12,8,4,8.0
barcode15,5,70942351,T,DEL,150,1,1,0,0.67
barcode15,5,70942352,T,DEL,152,1,1,0,0.66
barcode15,5,70942353,T,DEL,152,1,1,0,0.66
barcode15,5,70942354,G,DEL,239,1,1,0,0.42
barcode15,5,70942355,T,DEL,244,1,0,1,0.41
barcode15,5,70942359,G,DEL,287,2,0,2,0.7
barcode15,5,70942360,G,DEL,289,1,0,1,0.35
barcode15,5,70942361,A,DEL,289,21,1,20,7.27
barcode15,5,70942365,T,DEL,289,1,1,0,0.35
barcode15,5,70942367,G,DEL,291,17,9,8,5.84
barcode15,5,70942371,A,DEL,297,1,1,0,0.34
barcode15,5,70942372,C,DEL,297,2,0,2,0.67
barcode15,5,70942373,A,DEL,297,4,1,3,1.35
barcode15,5,70942374,A,DEL,297,1,1,0,0.34
barcode15,5,70942375,A,DEL,297,1,1,0,0.34
barcode15,5,70942376,T,DEL,297,1,1,0,0.34
barcode15,5,70942378,T,DEL,302,1,1,0,0.33
barcode15,5,70942379,T,DEL,303,2,2,0,0.66
barcode15,5,70942380,C,DEL,309,2,2,0,0.65
barcode15,5,70942381,T,DEL,310,1,0,1,0.32
barcode15,5,70942383,C,DEL,315,2,2,0,0.63
barcode15,5,70942386,T,DEL,316,7,7,0,2.22
barcode15,5,70942392,C,DEL,318,3,3,0,0.94
barcode15,5,70942393,A,DEL,320,7,0,7,2.19
barcode15,5,70942394,G,DEL,320,9,0,9,2.81
barcode15,5,70942395,A,DEL,320,3,3,0,0.94
barcode15,5,70942397,G,DEL,321,1,1,0,0.31
barcode15,5,70942398,A,DEL,321,9,9,0,2.8
barcode15,5,70942400,G,DEL,322,1,0,1,0.31
barcode15,5,70942401,G,DEL,323,1,1,0,0.31
barcode15,5,70942402,T,DEL,323,33,33,0,10.22
barcode15,5,70942404,G,DEL,323,2,0,2,0.62
barcode15,5,70942405,C,DEL,324,2,0,2,0.62
barcode15,5,70942407,T,DEL,324,17,15,2,5.25
barcode15,5,70942411,C,DEL,340,13,13,0,3.82
barcode15,5,70942415,G,DEL,344,2,2,0,0.58
barcode15,5,70942416,C,DEL,344,1,1,0,0.29
barcode15,5,70942422,T,DEL,347,2,2,0,0.58
barcode15,5,70942423,T,DEL,347,1,1,0,0.29
barcode15,5,70942424,G,DEL,359,1,1,0,0.28
barcode15,5,70942425,C,DEL,364,1,1,0,0.27
barcode15,5,70942426,T,DEL,368,17,17,0,4.62
barcode15,5,70942429,A,DEL,392,2,2,0,0.51
barcode15,5,70942431,T,DEL,392,1,1,0,0.26
barcode15,5,70942433,G,DEL,389,1,1,0,0.26
barcode15,5,70942435,T,DEL,390,10,8,2,2.56
barcode15,5,70942437,T,DEL,388,12,12,0,3.09
barcode15,5,70942438,T,DEL,386,32,32,0,8.29
barcode15,5,70942439,A,DEL,386,56,53,3,14.51
barcode15,5,70942440,A,DEL,388,37,37,0,9.54
barcode15,5,70942441,G,DEL,388,24,24,0,6.19
barcode15,5,70942442,A,DEL,392,16,16,0,4.08
barcode15,5,70942443,G,DEL,392,4,3,1,1.02
barcode15,5,70942444,A,DEL,394,7,7,0,1.78
barcode15,5,70942445,G,DEL,394,5,4,1,1.27
barcode15,5,70942446,A,DEL,393,4,4,0,1.02
barcode15,5,70942451,T,DEL,405,2,2,0,0.49
barcode15,5,70942452,G,DEL,405,2,2,0,0.49
barcode15,5,70942459,G,DEL,409,1,0,1,0.24
barcode15,5,70942461,T,DEL,410,3,3,0,0.73
barcode15,5,70942464,A,DEL,408,1,1,0,0.25
barcode15,5,70942465,C,DEL,431,1,1,0,0.23
barcode15,5,70942469,G,DEL,431,2,1,1,0.46
barcode15,5,70942470,G,DEL,432,1,0,1,0.23
barcode15,5,70942477,A,DEL,433,3,1,2,0.69
barcode15,5,70942478,A,DEL,433,1,0,1,0.23
barcode15,5,70942480,T,DEL,432,1,0,1,0.23
barcode15,5,70942481,A,DEL,430,14,12,2,3.26
barcode15,5,70942482,G,DEL,431,5,3,2,1.16
barcode15,5,70942483,A,DEL,432,4,4,0,0.93
barcode15,5,70942484,G,DEL,432,4,4,0,0.93
barcode15,5,70942485,A,DEL,433,6,6,0,1.39
barcode15,5,70942486,G,DEL,431,32,32,0,7.42
barcode15,5,70942487,G,DEL,430,7,7,0,1.63
barcode15,5,70942488,A,DEL,431,7,7,0,1.62
barcode15,5,70942489,G,DEL,428,5,5,0,1.17
barcode15,5,70942490,C,DEL,428,4,4,0,0.93
barcode15,5,70942491,A,DEL,427,6,4,2,1.41
barcode15,5,70942494,A,DEL,426,3,1,2,0.7
barcode15,5,70942495,T,DEL,426,8,4,4,1.88
barcode15,5,70942496,C,DEL,421,4,4,0,0.95
barcode15,5,70942497,T,DEL,421,4,2,2,0.95
barcode15,5,70942498,G,DEL,420,4,4,0,0.95
barcode15,5,70942499,T,DEL,420,3,2,1,0.71
barcode15,5,70942502,G,DEL,418,1,0,1,0.24
barcode15,5,70942504,T,DEL,418,2,2,0,0.48
barcode15,5,70942505,C,DEL,414,2,2,0,0.48
barcode15,5,70942506,T,DEL,413,2,0,2,0.48
barcode15,5,70942507,A,DEL,418,1,1,0,0.24
barcode15,5,70942508,C,DEL,418,3,3,0,0.72
barcode15,5,70942509,T,DEL,421,16,13,3,3.8
barcode15,5,70942510,T,DEL,423,2,0,2,0.47
barcode15,5,70942511,T,DEL,421,67,63,4,15.91
barcode15,5,70942512,C,DEL,421,175,168,7,41.57
barcode15,5,70942513,C,DEL,475,20,20,0,4.21
barcode15,5,70942516,A,DEL,479,1,1,0,0.21
barcode15,5,70942518,T,DEL,482,2,1,1,0.41
barcode15,5,70942519,C,DEL,499,3,2,1,0.6
barcode15,5,70942520,T,DEL,501,1,0,1,0.2
barcode15,5,70942521,G,DEL,501,1,0,1,0.2
barcode15,5,70942522,T,DEL,499,4,4,0,0.8
barcode15,5,70942524,A,DEL,499,2,0,2,0.4
barcode15,5,70942531,T,DEL,494,1,1,0,0.2
barcode15,5,70942532,A,DEL,492,1,1,0,0.2
barcode15,5,70942533,A,DEL,490,1,1,0,0.2
barcode15,5,70942535,A,DEL,484,1,0,1,0.21
barcode15,5,70942536,A,DEL,484,2,2,0,0.41
barcode15,5,70942537,T,DEL,484,2,2,0,0.41
barcode15,5,70942538,A,DEL,478,1,1,0,0.21
barcode15,5,70942539,T,DEL,476,1,1,0,0.21
barcode15,5,70942540,A,DEL,470,2,2,0,0.43
barcode15,5,70942541,G,DEL,470,12,12,0,2.55
barcode15,5,70942542,A,DEL,469,2,2,0,0.43
barcode15,5,70942545,A,DEL,462,4,4,0,0.87
barcode15,5,70942551,C,DEL,459,1,1,0,0.22
barcode15,5,70942553,C,DEL,457,1,1,0,0.22
barcode15,5,70942554,A,DEL,457,1,1,0,0.22
barcode15,5,70942557,A,DEL,454,16,16,0,3.52
barcode15,5,70942561,A,DEL,447,2,2,0,0.45
barcode15,5,70942562,A,DEL,446,1,1,0,0.22
barcode15,5,70942563,G,DEL,446,1,1,0,0.22
barcode15,5,70942564,G,DEL,440,1,1,0,0.23
barcode15,5,70942569,A,DEL,417,47,46,1,11.27
barcode15,5,70942570,A,DEL,417,40,39,1,9.59
barcode15,5,70942571,A,DEL,414,28,28,0,6.76
barcode15,5,70942572,A,DEL,412,8,8,0,1.94
barcode15,5,70942573,A,DEL,404,1,1,0,0.25
barcode15,5,70942580,A,DEL,181,1,1,0,0.55
barcode15,5,70942581,A,DEL,155,2,2,0,1.29
barcode15,5,70942582,T,DEL,150,2,2,0,1.33
barcode15,5,70942678,A,DEL,297,8,0,8,2.69
barcode15,5,70942683,T,DEL,395,1,0,1,0.25
barcode15,5,70942684,A,DEL,399,1,0,1,0.25
barcode15,5,70942686,A,DEL,406,1,0,1,0.25
barcode15,5,70942687,A,DEL,406,1,0,1,0.25
barcode15,5,70942688,C,DEL,408,1,0,1,0.25
barcode15,5,70942689,A,DEL,411,13,3,10,3.16
barcode15,5,70942696,T,DEL,430,1,0,1,0.23
barcode15,5,70942697,G,DEL,430,1,0,1,0.23
barcode15,5,70942698,C,DEL,430,1,0,1,0.23
barcode15,5,70942699,A,DEL,431,1,0,1,0.23
barcode15,5,70942700,T,DEL,431,3,0,3,0.7
barcode15,5,70942701,A,DEL,432,2,0,2,0.46
barcode15,5,70942702,T,DEL,433,13,1,12,3.0
barcode15,5,70942703,T,DEL,433,2,0,2,0.46
barcode15,5,70942704,T,DEL,433,2,0,2,0.46
barcode15,5,70942705,T,DEL,433,1,0,1,0.23
barcode15,5,70942706,T,DEL,436,3,0,3,0.69
barcode15,5,70942707,T,DEL,436,11,0,11,2.52
barcode15,5,70942708,C,DEL,438,21,2,19,4.79
barcode15,5,70942709,T,DEL,438,72,1,71,16.44
barcode15,5,70942710,T,DEL,439,12,0,12,2.73
barcode15,5,70942711,T,DEL,440,1,0,1,0.23
barcode15,5,70942713,T,DEL,441,4,0,4,0.91
barcode15,5,70942714,A,DEL,443,19,0,19,4.29
barcode15,5,70942718,A,DEL,449,4,0,4,0.89
barcode15,5,70942721,G,DEL,449,5,0,5,1.11
barcode15,5,70942722,A,DEL,453,62,13,49,13.69
barcode15,5,70942723,A,DEL,455,9,0,9,1.98
barcode15,5,70942727,G,DEL,458,29,0,29,6.33
barcode15,5,70942728,A,DEL,461,4,0,4,0.87
barcode15,5,70942729,A,DEL,463,1,0,1,0.22
barcode15,5,70942731,G,DEL,470,1,1,0,0.21
barcode15,5,70942732,C,DEL,473,1,0,1,0.21
barcode15,5,70942734,A,DEL,473,5,1,4,1.06
barcode15,5,70942737,T,DEL,472,4,0,4,0.85
barcode15,5,70942740,C,DEL,485,1,0,1,0.21
barcode15,5,70942741,A,DEL,485,8,1,7,1.65
barcode15,5,70942742,A,DEL,487,1,0,1,0.21
barcode15,5,70942743,C,DEL,487,3,0,3,0.62
barcode15,5,70942744,A,DEL,487,1,0,1,0.21
barcode15,5,70942745,G,DEL,487,3,0,3,0.62
barcode15,5,70942746,A,DEL,487,5,0,5,1.03
barcode15,5,70942747,T,DEL,488,3,0,3,0.61
barcode15,5,70942748,G,DEL,488,3,0,3,0.61
barcode15,5,70942749,A,DEL,491,32,0,32,6.52
barcode15,5,70942754,G,DEL,486,2,0,2,0.41
barcode15,5,70942755,A,DEL,486,5,1,4,1.03
barcode15,5,70942756,G,DEL,484,5,0,5,1.03
barcode15,5,70942757,A,DEL,486,10,2,8,2.06
barcode15,5,70942761,C,DEL,503,6,1,5,1.19
barcode15,5,70942762,C,DEL,503,1,1,0,0.2
barcode15,5,70942764,G,DEL,504,3,3,0,0.6
barcode15,5,70942766,T,DEL,502,13,0,13,2.59
barcode15,5,70942767,C,DEL,501,26,1,25,5.19
barcode15,5,70942768,T,DEL,507,3,1,2,0.59
barcode15,5,70942769,C,DEL,510,3,1,2,0.59
barcode15,5,70942770,C,DEL,519,2,0,2,0.39
barcode15,5,70942771,T,DEL,521,3,0,3,0.58
barcode15,5,70942772,G,DEL,522,9,0,9,1.72
barcode15,5,70942773,G,DEL,520,2,0,2,0.38
barcode15,5,70942774,A,DEL,522,9,0,9,1.72
barcode15,5,70942775,A,DEL,515,3,0,3,0.58
barcode15,5,70942776,A,DEL,515,3,0,3,0.58
barcode15,5,70942777,T,DEL,515,5,0,5,0.97
barcode15,5,70942778,A,DEL,514,3,0,3,0.58
barcode15,5,70942783,A,DEL,521,1,0,1,0.19
barcode15,5,70942784,G,DEL,521,3,1,2,0.58
barcode15,5,70942785,A,DEL,450,3,0,3,0.67
barcode15,5,70942786,T,DEL,451,5,0,5,1.11
barcode15,5,70942787,A,DEL,423,2,0,2,0.47
barcode15,5,70942793,A,DEL,428,2,0,2,0.47
barcode15,5,70942796,C,DEL,427,5,2,3,1.17
barcode15,5,70942798,C,DEL,415,3,0,3,0.72
barcode15,5,70942799,A,DEL,400,3,0,3,0.75
barcode15,5,70942800,A,DEL,401,2,0,2,0.5
barcode15,5,70942801,A,DEL,400,2,0,2,0.5
barcode15,5,70942802,T,DEL,398,12,1,11,3.02
barcode15,5,70942803,C,DEL,401,7,1,6,1.75
barcode15,5,70942804,T,DEL,403,3,0,3,0.74
barcode15,5,70942805,G,DEL,435,2,1,1,0.46
barcode15,5,70942806,C,DEL,435,3,1,2,0.69
barcode15,5,70942808,C,DEL,449,6,2,4,1.34
barcode15,5,70942812,G,DEL,442,1,1,0,0.23
barcode15,5,70942814,A,DEL,441,1,0,1,0.23
barcode15,5,70942816,C,DEL,422,4,0,4,0.95
barcode15,5,70942817,T,DEL,422,6,1,5,1.42
barcode15,5,70942818,C,DEL,421,8,2,6,1.9
barcode15,5,70942819,T,DEL,421,30,10,20,7.13
barcode15,5,70942820,T,DEL,421,3,0,3,0.71
barcode15,5,70942821,T,DEL,421,2,0,2,0.48
barcode15,5,70942822,T,DEL,418,18,0,18,4.31
barcode15,5,70942823,C,DEL,419,31,0,31,7.4
barcode15,5,70942824,T,DEL,419,27,0,27,6.44
barcode15,5,70942825,C,DEL,424,69,12,57,16.27
barcode15,5,70942826,C,DEL,429,25,0,25,5.83
barcode15,5,70942827,C,DEL,433,9,0,9,2.08
barcode15,5,70942828,T,DEL,432,10,0,10,2.31
barcode15,5,70942829,C,DEL,430,22,1,21,5.12
barcode15,5,70942830,C,DEL,436,4,1,3,0.92
barcode15,5,70942831,A,DEL,435,1,1,0,0.23
barcode15,5,70942832,C,DEL,433,1,1,0,0.23
barcode15,5,70942833,C,DEL,432,1,0,1,0.23
barcode15,5,70942834,A,DEL,432,2,0,2,0.46
barcode15,5,70942835,C,DEL,432,113,80,33,26.16
barcode15,5,70942836,C,DEL,424,13,12,1,3.07
barcode15,5,70942837,C,DEL,425,8,7,1,1.88
barcode15,5,70942838,C,DEL,424,7,6,1,1.65
barcode15,5,70942839,C,DEL,421,1,0,1,0.24
barcode15,5,70942840,C,DEL,420,1,0,1,0.24
barcode15,5,70942841,A,DEL,420,1,0,1,0.24
barcode15,5,70942842,T,DEL,420,1,0,1,0.24
barcode15,5,70942844,C,DEL,422,9,9,0,2.13
barcode15,5,70942845,C,DEL,422,1,1,0,0.24
barcode15,5,70942846,A,DEL,422,1,1,0,0.24
barcode15,5,70942847,G,DEL,422,3,3,0,0.71
barcode15,5,70942852,A,DEL,413,27,8,19,6.54
barcode15,5,70942853,A,DEL,413,2,1,1,0.48
barcode15,5,70942854,G,DEL,412,2,1,1,0.49
barcode15,5,70942855,A,DEL,414,2,2,0,0.48
barcode15,5,70942856,C,DEL,414,2,1,1,0.48
barcode15,5,70942857,T,DEL,414,30,1,29,7.25
barcode15,5,70942858,G,DEL,412,15,0,15,3.64
barcode15,5,70942867,A,DEL,403,25,6,19,6.2
barcode15,5,70942870,G,DEL,401,1,0,1,0.25
barcode15,5,70942872,T,DEL,400,4,0,4,1.0
barcode15,5,70942873,A,DEL,398,1,0,1,0.25
barcode15,5,70942874,A,DEL,398,1,0,1,0.25
barcode15,5,70942876,C,DEL,399,1,0,1,0.25
barcode15,5,70942878,T,DEL,400,4,2,2,1.0
barcode15,5,70942879,T,DEL,400,1,0,1,0.25
barcode15,5,70942880,C,DEL,400,1,0,1,0.25
barcode15,5,70942881,T,DEL,399,10,0,10,2.51
barcode15,5,70942882,A,DEL,398,1,0,1,0.25
barcode15,5,70942883,T,DEL,397,1,0,1,0.25
barcode15,5,70942884,G,DEL,395,2,0,2,0.51
barcode15,5,70942885,A,DEL,393,20,0,20,5.09
barcode15,5,70942886,A,DEL,393,2,0,2,0.51
barcode15,5,70942888,G,DEL,388,2,0,2,0.52
barcode15,5,70942889,T,DEL,386,8,5,3,2.07
barcode15,5,70942893,C,DEL,384,1,1,0,0.26
barcode15,5,70942894,C,DEL,384,1,0,1,0.26
barcode15,5,70942895,A,DEL,383,14,6,8,3.66
barcode15,5,70942896,G,DEL,382,15,7,8,3.93
barcode15,5,70942897,A,DEL,371,8,0,8,2.16
barcode15,5,70942904,T,DEL,367,4,4,0,1.09
barcode15,5,70942906,A,DEL,362,54,0,54,14.92
barcode15,5,70942908,T,DEL,358,3,3,0,0.84
barcode15,5,70942909,G,DEL,356,3,3,0,0.84
barcode15,5,70942911,C,DEL,356,5,3,2,1.4
barcode15,5,70942912,G,DEL,353,10,0,10,2.83
barcode15,5,70942915,A,DEL,327,2,1,1,0.61
barcode15,5,70942918,T,DEL,325,14,7,7,4.31
barcode15,5,70942920,T,DEL,321,10,0,10,3.12
barcode15,5,70942921,A,DEL,321,12,0,12,3.74
barcode15,5,70942923,C,DEL,320,1,0,1,0.31
barcode15,5,70942924,C,DEL,320,1,0,1,0.31
barcode15,5,70942925,T,DEL,320,1,0,1,0.31
barcode15,5,70942926,C,DEL,317,1,1,0,0.32
barcode15,5,70942927,T,DEL,315,2,1,1,0.63
barcode15,5,70942928,C,DEL,307,1,1,0,0.33
barcode15,5,70942929,T,DEL,307,9,1,8,2.93
barcode15,5,70942930,G,DEL,304,2,2,0,0.66
barcode15,5,70942931,T,DEL,300,10,10,0,3.33
barcode15,5,70942939,T,DEL,257,7,7,0,2.72
barcode15,5,70942948,C,DEL,138,3,0,3,2.17
barcode15,5,70944618,A,DEL,224,1,0,1,0.45
barcode15,5,70944621,T,DEL,245,2,0,2,0.82
barcode15,5,70944625,T,DEL,270,5,0,5,1.85
barcode15,5,70944626,A,DEL,278,17,1,16,6.12
barcode15,5,70944628,G,DEL,288,2,0,2,0.69
barcode15,5,70944632,A,DEL,295,1,0,1,0.34
barcode15,5,70944633,T,DEL,295,14,0,14,4.75
barcode15,5,70944639,T,DEL,311,4,2,2,1.29
barcode15,5,70944642,G,DEL,314,6,0,6,1.91
barcode15,5,70944643,A,DEL,318,2,0,2,0.63
barcode15,5,70944648,T,DEL,326,7,0,7,2.15
barcode15,5,70944649,T,DEL,328,6,0,6,1.83
barcode15,5,70944650,C,DEL,332,8,0,8,2.41
barcode15,5,70944652,T,DEL,334,6,2,4,1.8
barcode15,5,70944653,T,DEL,336,4,0,4,1.19
barcode15,5,70944660,A,DEL,363,1,0,1,0.28
barcode15,5,70944661,G,DEL,363,3,2,1,0.83
barcode15,5,70944662,G,DEL,363,1,0,1,0.28
barcode15,5,70944663,T,DEL,365,1,0,1,0.27
barcode15,5,70944664,C,DEL,365,2,0,2,0.55
barcode15,5,70944665,T,DEL,366,13,0,13,3.55
barcode15,5,70944666,A,DEL,368,10,0,10,2.72
barcode15,5,70944667,A,DEL,370,3,0,3,0.81
barcode15,5,70944668,A,DEL,370,3,0,3,0.81
barcode15,5,70944669,A,DEL,370,1,0,1,0.27
barcode15,5,70944670,T,DEL,372,4,0,4,1.08
barcode15,5,70944672,C,DEL,372,2,0,2,0.54
barcode15,5,70944673,A,DEL,373,1,0,1,0.27
barcode15,5,70944678,C,DEL,380,11,1,10,2.89
barcode15,5,70944679,C,DEL,384,2,1,1,0.52
barcode15,5,70944680,C,DEL,386,2,1,1,0.52
barcode15,5,70944681,A,DEL,385,4,3,1,1.04
barcode15,5,70944682,C,DEL,386,1,0,1,0.26
barcode15,5,70944683,C,DEL,390,2,1,1,0.51
barcode15,5,70944684,A,DEL,391,3,1,2,0.77
barcode15,5,70944685,C,DEL,391,3,1,2,0.77
barcode15,5,70944686,C,DEL,390,4,2,2,1.03
barcode15,5,70944687,G,DEL,393,3,1,2,0.76
barcode15,5,70944688,C,DEL,396,1,1,0,0.25
barcode15,5,70944689,C,DEL,394,1,1,0,0.25
barcode15,5,70944690,A,DEL,396,1,1,0,0.25
barcode15,5,70944691,C,DEL,397,1,1,0,0.25
barcode15,5,70944694,C,DEL,404,5,0,5,1.24
barcode15,5,70944695,C,DEL,407,7,2,5,1.72
barcode15,5,70944696,A,DEL,411,8,3,5,1.95
barcode15,5,70944703,C,DEL,427,1,1,0,0.23
barcode15,5,70944704,C,DEL,427,1,1,0,0.23
barcode15,5,70944705,A,DEL,429,1,1,0,0.23
barcode15,5,70944706,C,DEL,429,40,38,2,9.32
barcode15,5,70944707,C,DEL,435,2,0,2,0.46
barcode15,5,70944712,T,DEL,437,1,0,1,0.23
barcode15,5,70944713,T,DEL,430,1,1,0,0.23
barcode15,5,70944714,A,DEL,436,13,13,0,2.98
barcode15,5,70944715,C,DEL,435,1,1,0,0.23
barcode15,5,70944723,C,DEL,437,2,0,2,0.46
barcode15,5,70944724,T,DEL,437,10,0,10,2.29
barcode15,5,70944727,C,DEL,438,2,0,2,0.46
barcode15,5,70944728,T,DEL,436,4,0,4,0.92
barcode15,5,70944730,C,DEL,438,5,0,5,1.14
barcode15,5,70944736,T,DEL,439,6,1,5,1.37
barcode15,5,70944740,C,DEL,440,3,1,2,0.68
barcode15,5,70944741,T,DEL,441,14,6,8,3.17
barcode15,5,70944742,T,DEL,446,2,1,1,0.45
barcode15,5,70944743,C,DEL,449,2,0,2,0.45
barcode15,5,70944744,T,DEL,450,1,0,1,0.22
barcode15,5,70944746,G,DEL,442,1,0,1,0.23
barcode15,5,70944747,A,DEL,439,1,0,1,0.23
barcode15,5,70944748,C,DEL,435,1,0,1,0.23
barcode15,5,70944749,C,DEL,436,1,0,1,0.23
barcode15,5,70944751,C,DEL,447,2,2,0,0.45
barcode15,5,70944753,A,DEL,446,4,1,3,0.9
barcode15,5,70944754,G,DEL,446,5,1,4,1.12
barcode15,5,70944755,T,DEL,445,9,1,8,2.02
barcode15,5,70944756,A,DEL,431,9,1,8,2.09
barcode15,5,70944757,A,DEL,431,7,0,7,1.62
barcode15,5,70944758,G,DEL,431,7,0,7,1.62
barcode15,5,70944759,T,DEL,432,18,0,18,4.17
barcode15,5,70944760,A,DEL,426,99,3,96,23.24
barcode15,5,70944761,A,DEL,425,45,0,45,10.59
barcode15,5,70944762,A,DEL,425,41,0,41,9.65
barcode15,5,70944763,A,DEL,422,11,0,11,2.61
barcode15,5,70944767,A,DEL,417,1,1,0,0.24
barcode15,5,70944769,T,DEL,416,21,0,21,5.05
barcode15,5,70944770,A,DEL,412,1,0,1,0.24
barcode15,5,70944771,T,DEL,412,1,0,1,0.24
barcode15,5,70944777,A,DEL,400,4,0,4,1.0
barcode15,5,70944778,G,DEL,399,5,1,4,1.25
barcode15,5,70944780,T,DEL,399,12,7,5,3.01
barcode15,5,70944781,T,DEL,394,1,1,0,0.25
barcode15,5,70944785,C,DEL,389,1,0,1,0.26
barcode15,5,70944786,T,DEL,389,3,2,1,0.77
barcode15,5,70944787,T,DEL,387,1,1,0,0.26
barcode15,5,70944790,A,DEL,379,2,0,2,0.53
barcode15,5,70944793,T,DEL,364,1,0,1,0.27
barcode15,5,70944798,T,DEL,344,3,2,1,0.87
barcode15,5,70944800,T,DEL,339,1,0,1,0.29
barcode15,5,70944801,G,DEL,339,1,0,1,0.29
barcode15,5,70944802,A,DEL,333,1,0,1,0.3
barcode15,5,70944806,T,DEL,323,1,0,1,0.31
barcode15,5,70944809,G,DEL,318,2,1,1,0.63
barcode15,5,70944810,C,DEL,312,1,0,1,0.32
barcode15,5,70944811,A,DEL,307,1,0,1,0.33
barcode15,5,70944813,A,DEL,299,3,3,0,1.0
barcode15,5,70944816,A,DEL,279,4,4,0,1.43
barcode15,5,70944819,G,DEL,266,5,5,0,1.88
barcode15,5,70944820,G,DEL,257,1,1,0,0.39
barcode15,5,70944821,A,DEL,255,1,1,0,0.39
barcode15,5,70944825,T,DEL,242,1,0,1,0.41
barcode15,5,70944826,A,DEL,234,8,6,2,3.42
barcode15,5,70945984,C,DEL,292,8,0,8,2.74
barcode15,5,70945987,G,DEL,323,1,0,1,0.31
barcode15,5,70945990,T,DEL,344,3,3,0,0.87
barcode15,5,70945995,T,DEL,369,3,3,0,0.81
barcode15,5,70945996,A,DEL,371,3,3,0,0.81
barcode15,5,70946000,A,DEL,381,4,0,4,1.05
barcode15,5,70946002,T,DEL,383,1,0,1,0.26
barcode15,5,70946004,T,DEL,389,2,2,0,0.51
barcode15,5,70946005,A,DEL,391,4,0,4,1.02
barcode15,5,70946006,A,DEL,393,1,0,1,0.25
barcode15,5,70946010,T,DEL,487,1,1,0,0.21
barcode15,5,70946011,C,DEL,488,3,2,1,0.61
barcode15,5,70946012,C,DEL,491,3,1,2,0.61
barcode15,5,70946013,A,DEL,517,7,0,7,1.35
barcode15,5,70946014,G,DEL,518,8,1,7,1.54
barcode15,5,70946015,A,DEL,519,1,0,1,0.19
barcode15,5,70946017,T,DEL,530,7,7,0,1.32
barcode15,5,70946018,T,DEL,530,1,1,0,0.19
barcode15,5,70946019,T,DEL,531,3,3,0,0.56
barcode15,5,70946020,A,DEL,549,5,5,0,0.91
barcode15,5,70946021,C,DEL,550,1,1,0,0.18
barcode15,5,70946022,T,DEL,553,45,17,28,8.14
barcode15,5,70946023,T,DEL,554,2,1,1,0.36
barcode15,5,70946024,T,DEL,554,1,1,0,0.18
barcode15,5,70946027,T,DEL,569,3,3,0,0.53
barcode15,5,70946028,G,DEL,598,3,3,0,0.5
barcode15,5,70946029,T,DEL,606,4,2,2,0.66
barcode15,5,70946031,T,DEL,621,2,1,1,0.32
barcode15,5,70946032,A,DEL,653,10,9,1,1.53
barcode15,5,70946033,C,DEL,658,9,1,8,1.37
barcode15,5,70946034,T,DEL,663,1,0,1,0.15
barcode15,5,70946035,G,DEL,666,2,0,2,0.3
barcode15,5,70946036,G,DEL,666,2,0,2,0.3
barcode15,5,70946037,A,DEL,669,5,0,5,0.75
barcode15,5,70946038,T,DEL,669,4,0,4,0.6
barcode15,5,70946039,A,DEL,674,1,0,1,0.15
barcode15,5,70946040,T,DEL,674,1,0,1,0.15
barcode15,5,70946041,A,DEL,686,38,2,36,5.54
barcode15,5,70946042,A,DEL,691,2,2,0,0.29
barcode15,5,70946043,A,DEL,691,3,2,1,0.43
barcode15,5,70946044,C,DEL,693,1,0,1,0.14
barcode15,5,70946045,A,DEL,694,3,0,3,0.43
barcode15,5,70946046,A,DEL,694,7,6,1,1.01
barcode15,5,70946047,T,DEL,694,9,8,1,1.3
barcode15,5,70946048,A,DEL,707,2,1,1,0.28
barcode15,5,70946049,T,DEL,707,4,4,0,0.57
barcode15,5,70946050,C,DEL,708,8,4,4,1.13
barcode15,5,70946051,T,DEL,710,152,133,19,21.41
barcode15,5,70946052,T,DEL,713,38,36,2,5.33
barcode15,5,70946053,T,DEL,714,12,12,0,1.68
barcode15,5,70946054,T,DEL,716,6,5,1,0.84
barcode15,5,70946055,T,DEL,718,9,8,1,1.25
barcode15,5,70946056,C,DEL,720,14,13,1,1.94
barcode15,5,70946057,T,DEL,720,3,1,2,0.42
barcode15,5,70946058,G,DEL,722,3,2,1,0.42
barcode15,5,70946060,C,DEL,725,12,0,12,1.66
barcode15,5,70946061,T,DEL,732,1,1,0,0.14
barcode15,5,70946062,C,DEL,731,4,4,0,0.55
barcode15,5,70946063,C,DEL,743,1,1,0,0.13
barcode15,5,70946064,A,DEL,744,1,1,0,0.13
barcode15,5,70946065,G,DEL,748,4,1,3,0.53
barcode15,5,70946066,A,DEL,747,19,1,18,2.54
barcode15,5,70946067,T,DEL,748,18,0,18,2.41
barcode15,5,70946068,A,DEL,749,3,0,3,0.4
barcode15,5,70946069,A,DEL,749,4,0,4,0.53
barcode15,5,70946070,T,DEL,750,3,1,2,0.4
barcode15,5,70946071,T,DEL,750,2,1,1,0.27
barcode15,5,70946072,C,DEL,752,166,74,92,22.07
barcode15,5,70946073,C,DEL,755,36,26,10,4.77
barcode15,5,70946074,C,DEL,758,3,3,0,0.4
barcode15,5,70946075,C,DEL,760,3,3,0,0.39
barcode15,5,70946076,C,DEL,759,3,3,0,0.4
barcode15,5,70946077,A,DEL,760,3,3,0,0.39
barcode15,5,70946078,C,DEL,763,2,1,1,0.26
barcode15,5,70946079,C,DEL,762,1,1,0,0.13
barcode15,5,70946080,A,DEL,764,1,1,0,0.13
barcode15,5,70946082,C,DEL,764,1,1,0,0.13
barcode15,5,70946083,T,DEL,765,5,4,1,0.65
barcode15,5,70946084,C,DEL,770,164,163,1,21.3
barcode15,5,70946086,C,DEL,772,1,1,0,0.13
barcode15,5,70946087,A,DEL,771,16,3,13,2.08
barcode15,5,70946088,T,DEL,771,16,3,13,2.08
barcode15,5,70946090,T,DEL,761,4,4,0,0.53
barcode15,5,70946091,G,DEL,763,4,4,0,0.52
barcode15,5,70946093,C,DEL,762,5,5,0,0.66
barcode15,5,70946094,C,DEL,764,1,0,1,0.13
barcode15,5,70946095,A,DEL,764,4,2,2,0.52
barcode15,5,70946096,G,DEL,762,8,2,6,1.05
barcode15,5,70946097,A,DEL,766,2,1,1,0.26
barcode15,5,70946098,T,DEL,771,4,2,2,0.52
barcode15,5,70946099,T,DEL,771,95,11,84,12.32
barcode15,5,70946100,C,DEL,773,104,15,89,13.45
barcode15,5,70946102,C,DEL,776,4,3,1,0.52
barcode15,5,70946103,T,DEL,788,11,8,3,1.4
barcode15,5,70946104,T,DEL,791,12,0,12,1.52
barcode15,5,70946105,G,DEL,788,13,0,13,1.65
barcode15,5,70946106,A,DEL,798,1,0,1,0.13
barcode15,5,70946107,T,DEL,800,1,0,1,0.12
barcode15,5,70946108,G,DEL,799,1,0,1,0.13
barcode15,5,70946110,T,DEL,789,1,1,0,0.13
barcode15,5,70946111,G,DEL,792,1,1,0,0.13
barcode15,5,70946112,C,DEL,791,3,3,0,0.38
barcode15,5,70946113,T,DEL,792,2,0,2,0.25
barcode15,5,70946117,G,DEL,797,1,1,0,0.13
barcode15,5,70946118,C,DEL,797,5,1,4,0.63
barcode15,5,70946119,T,DEL,800,3,2,1,0.38
barcode15,5,70946120,T,DEL,806,1,1,0,0.12
barcode15,5,70946121,T,DEL,808,1,1,0,0.12
barcode15,5,70946122,G,DEL,810,48,6,42,5.93
barcode15,5,70946124,G,DEL,811,3,0,3,0.37
barcode15,5,70946125,A,DEL,813,9,2,7,1.11
barcode15,5,70946126,A,DEL,809,1,1,0,0.12
barcode15,5,70946127,G,DEL,807,10,6,4,1.24
barcode15,5,70946128,T,DEL,804,19,5,14,2.36
barcode15,5,70946129,A,DEL,817,4,4,0,0.49
barcode15,5,70946130,T,DEL,817,1,1,0,0.12
barcode15,5,70946131,G,DEL,817,1,1,0,0.12
barcode15,5,70946132,T,DEL,817,148,147,1,18.12
barcode15,5,70946133,T,DEL,818,2,1,1,0.24
barcode15,5,70946134,A,DEL,817,5,0,5,0.61
barcode15,5,70946136,T,DEL,823,8,5,3,0.97
barcode15,5,70946143,G,DEL,839,5,0,5,0.6
barcode15,5,70946144,T,DEL,840,7,0,7,0.83
barcode15,5,70946145,A,DEL,830,1,0,1,0.12
barcode15,5,70946146,C,DEL,832,1,1,0,0.12
barcode15,5,70946147,A,DEL,838,1,1,0,0.12
barcode15,5,70946148,T,DEL,838,1,1,0,0.12
barcode15,5,70946149,G,DEL,839,1,1,0,0.12
barcode15,5,70946150,A,DEL,846,4,4,0,0.47
barcode15,5,70946162,A,DEL,892,1,0,1,0.11
barcode15,5,70946163,C,DEL,887,2,0,2,0.23
barcode15,5,70946164,T,DEL,889,1,0,1,0.11
barcode15,5,70946168,T,DEL,885,4,4,0,0.45
barcode15,5,70946169,A,DEL,878,5,5,0,0.57
barcode15,5,70946170,T,DEL,876,10,10,0,1.14
barcode15,5,70946171,T,DEL,869,28,28,0,3.22
barcode15,5,70946172,A,DEL,873,29,29,0,3.32
barcode15,5,70946173,T,DEL,872,4,4,0,0.46
barcode15,5,70946174,A,DEL,890,4,4,0,0.45
barcode15,5,70946175,T,DEL,891,2,0,2,0.22
barcode15,5,70946176,G,DEL,891,1,0,1,0.11
barcode15,5,70946177,G,DEL,905,8,0,8,0.88
barcode15,5,70946178,T,DEL,905,8,0,8,0.88
barcode15,5,70946179,A,DEL,899,3,2,1,0.33
barcode15,5,70946180,A,DEL,900,2,0,2,0.22
barcode15,5,70946181,G,DEL,898,2,0,2,0.22
barcode15,5,70946182,T,DEL,897,3,0,3,0.33
barcode15,5,70946183,A,DEL,891,15,0,15,1.68
barcode15,5,70946190,C,DEL,918,19,1,18,2.07
barcode15,5,70946191,A,DEL,923,1,1,0,0.11
barcode15,5,70946192,G,DEL,922,4,4,0,0.43
barcode15,5,70946194,A,DEL,954,1,0,1,0.1
barcode15,5,70946195,T,DEL,956,5,5,0,0.52
barcode15,5,70946196,C,DEL,959,6,6,0,0.63
barcode15,5,70946197,T,DEL,968,227,206,21,23.45
barcode15,5,70946198,T,DEL,969,10,10,0,1.03
barcode15,5,70946200,T,DEL,969,1,1,0,0.1
barcode15,5,70946201,C,DEL,967,1,1,0,0.1
barcode15,5,70946202,C,DEL,968,2,1,1,0.21
barcode15,5,70946203,T,DEL,967,1,0,1,0.1
barcode15,5,70946204,G,DEL,967,12,0,12,1.24
barcode15,5,70946209,T,DEL,962,46,41,5,4.78
barcode15,5,70946210,T,DEL,963,2,2,0,0.21
barcode15,5,70946214,T,DEL,972,1,1,0,0.1
barcode15,5,70946215,T,DEL,972,2,2,0,0.21
barcode15,5,70946216,G,DEL,985,2,2,0,0.2
barcode15,5,70946220,T,DEL,992,1,1,0,0.1
barcode15,5,70946223,T,DEL,992,1,1,0,0.1
barcode15,5,70946224,G,DEL,1001,1,1,0,0.1
barcode15,5,70946225,T,DEL,1000,1,1,0,0.1
barcode15,5,70946228,C,DEL,987,1,0,1,0.1
barcode15,5,70946229,T,DEL,987,18,18,0,1.82
barcode15,5,70946233,T,DEL,973,36,28,8,3.7
barcode15,5,70946234,T,DEL,973,2,2,0,0.21
barcode15,5,70946237,G,DEL,968,1,0,1,0.1
barcode15,5,70946239,A,DEL,964,7,5,2,0.73
barcode15,5,70946241,A,DEL,961,3,3,0,0.31
barcode15,5,70946242,T,DEL,962,23,9,14,2.39
barcode15,5,70946243,T,DEL,961,3,3,0,0.31
barcode15,5,70946244,T,DEL,961,3,3,0,0.31
barcode15,5,70946245,A,DEL,948,7,7,0,0.74
barcode15,5,70946246,T,DEL,946,2,1,1,0.21
barcode15,5,70946247,A,DEL,942,21,15,6,2.23
barcode15,5,70946251,T,DEL,938,1,1,0,0.11
barcode15,5,70946252,A,DEL,938,4,4,0,0.43
barcode15,5,70946253,C,DEL,938,6,6,0,0.64
barcode15,5,70946255,A,DEL,935,4,4,0,0.43
barcode15,5,70946256,C,DEL,933,3,3,0,0.32
barcode15,5,70946257,T,DEL,933,3,3,0,0.32
barcode15,5,70946260,C,DEL,928,3,2,1,0.32
barcode15,5,70946261,T,DEL,928,13,12,1,1.4
barcode15,5,70946262,T,DEL,926,18,17,1,1.94
barcode15,5,70946263,C,DEL,920,19,17,2,2.07
barcode15,5,70946264,T,DEL,920,1,1,0,0.11
barcode15,5,70946265,C,DEL,917,3,3,0,0.33
barcode15,5,70946266,T,DEL,916,4,2,2,0.44
barcode15,5,70946267,C,DEL,900,2,2,0,0.22
barcode15,5,70946268,T,DEL,898,87,87,0,9.69
barcode15,5,70946270,T,DEL,891,1,1,0,0.11
barcode15,5,70946271,A,DEL,886,3,3,0,0.34
barcode15,5,70946273,A,DEL,869,1,1,0,0.12
barcode15,5,70946274,T,DEL,868,4,4,0,0.46
barcode15,5,70946275,T,DEL,866,4,4,0,0.46
barcode15,5,70946276,A,DEL,858,14,14,0,1.63
barcode15,5,70946277,C,DEL,856,4,4,0,0.47
barcode15,5,70946279,A,DEL,845,19,13,6,2.25
barcode15,5,70946280,A,DEL,842,1,1,0,0.12
barcode15,5,70946286,A,DEL,821,28,28,0,3.41
barcode15,5,70946287,A,DEL,821,1,1,0,0.12
barcode15,5,70946289,A,DEL,819,2,2,0,0.24
barcode15,5,70946290,A,DEL,817,2,2,0,0.24
barcode15,5,70946291,T,DEL,816,2,2,0,0.25
barcode15,5,70946292,A,DEL,803,107,99,8,13.33
barcode15,5,70946293,A,DEL,802,35,35,0,4.36
barcode15,5,70946294,A,DEL,796,11,11,0,1.38
barcode15,5,70946299,T,DEL,767,1,1,0,0.13
barcode15,5,70946301,C,DEL,749,1,1,0,0.13
barcode15,5,70946302,A,DEL,738,1,1,0,0.14
barcode15,5,70946305,T,DEL,730,6,6,0,0.82
barcode15,5,70946306,G,DEL,721,6,6,0,0.83
barcode15,5,70946308,C,DEL,635,3,3,0,0.47
barcode15,5,70946309,T,DEL,631,1,0,1,0.16
barcode15,5,70946310,G,DEL,607,1,1,0,0.16
barcode15,5,70946311,A,DEL,598,1,1,0,0.17
barcode15,5,70946312,G,DEL,581,1,1,0,0.17
barcode15,5,70946315,T,DEL,492,1,1,0,0.2
barcode15,5,70951929,T,DEL,1,1,1,0,100.0
barcode15,5,70951943,T,DEL,622,16,2,14,2.57
barcode15,5,70951946,C,DEL,651,1,0,1,0.15
barcode15,5,70951947,A,DEL,654,2,0,2,0.31
barcode15,5,70951948,G,DEL,654,10,1,9,1.53
barcode15,5,70951949,A,DEL,659,1,0,1,0.15
barcode15,5,70951950,C,DEL,659,1,0,1,0.15
barcode15,5,70951951,A,DEL,659,121,6,115,18.36
barcode15,5,70951956,C,DEL,666,2,1,1,0.3
barcode15,5,70951957,A,DEL,667,112,14,98,16.79
barcode15,5,70951958,A,DEL,668,19,3,16,2.84
barcode15,5,70951959,A,DEL,673,1,1,0,0.15
barcode15,5,70951960,A,DEL,675,1,1,0,0.15
barcode15,5,70951961,A,DEL,678,2,1,1,0.29
barcode15,5,70951962,G,DEL,680,3,1,2,0.44
barcode15,5,70951963,A,DEL,687,42,0,42,6.11
barcode15,5,70951965,G,DEL,688,2,0,2,0.29
barcode15,5,70951967,A,DEL,698,53,1,52,7.59
barcode15,5,70951968,A,DEL,698,1,1,0,0.14
barcode15,5,70951969,G,DEL,699,2,2,0,0.29
barcode15,5,70951972,G,DEL,709,2,0,2,0.28
barcode15,5,70951973,C,DEL,712,6,0,6,0.84
barcode15,5,70951974,T,DEL,722,1,1,0,0.14
barcode15,5,70951976,A,DEL,731,5,0,5,0.68
barcode15,5,70951977,C,DEL,732,1,1,0,0.14
barcode15,5,70951978,A,DEL,736,5,1,4,0.68
barcode15,5,70951979,T,DEL,741,4,2,2,0.54
barcode15,5,70951980,T,DEL,742,2,0,2,0.27
barcode15,5,70951981,C,DEL,744,3,0,3,0.4
barcode15,5,70951982,C,DEL,746,1,0,1,0.13
barcode15,5,70951983,T,DEL,748,20,9,11,2.67
barcode15,5,70951984,T,DEL,748,9,0,9,1.2
barcode15,5,70951985,A,DEL,751,20,10,10,2.66
barcode15,5,70951986,A,DEL,754,1,0,1,0.13
barcode15,5,70951987,A,DEL,758,1,1,0,0.13
barcode15,5,70951988,T,DEL,759,1,1,0,0.13
barcode15,5,70951990,A,DEL,765,12,0,12,1.57
barcode15,5,70951994,A,DEL,775,1,1,0,0.13
barcode15,5,70951995,G,DEL,775,7,0,7,0.9
barcode15,5,70951996,T,DEL,775,1,0,1,0.13
barcode15,5,70951997,A,DEL,776,1,0,1,0.13
barcode15,5,70952001,C,DEL,794,9,1,8,1.13
barcode15,5,70952002,T,DEL,799,5,0,5,0.63
barcode15,5,70952003,G,DEL,838,2,0,2,0.24
barcode15,5,70952004,C,DEL,857,13,7,6,1.52
barcode15,5,70952005,C,DEL,856,6,0,6,0.7
barcode15,5,70952007,G,DEL,864,2,0,2,0.23
barcode15,5,70952008,C,DEL,864,1,0,1,0.12
barcode15,5,70952010,T,DEL,865,2,1,1,0.23
barcode15,5,70952011,T,DEL,866,1,1,0,0.12
barcode15,5,70952012,A,DEL,878,2,1,1,0.23
barcode15,5,70952013,T,DEL,879,1,0,1,0.11
barcode15,5,70952014,G,DEL,880,2,0,2,0.23
barcode15,5,70952015,A,DEL,884,143,32,111,16.18
barcode15,5,70952020,G,DEL,885,1,0,1,0.11
barcode15,5,70952023,T,DEL,891,5,2,3,0.56
barcode15,5,70952024,C,DEL,888,3,2,1,0.34
barcode15,5,70952025,T,DEL,888,8,5,3,0.9
barcode15,5,70952026,T,DEL,889,1,0,1,0.11
barcode15,5,70952028,C,DEL,897,1,1,0,0.11
barcode15,5,70952029,T,DEL,899,76,11,65,8.45
barcode15,5,70952031,T,DEL,892,3,3,0,0.34
barcode15,5,70952032,T,DEL,890,6,6,0,0.67
barcode15,5,70952033,G,DEL,901,9,8,1,1.0
barcode15,5,70952034,T,DEL,898,22,0,22,2.45
barcode15,5,70952035,A,DEL,903,4,0,4,0.44
barcode15,5,70952039,C,DEL,897,1,1,0,0.11
barcode15,5,70952040,T,DEL,898,2,2,0,0.22
barcode15,5,70952047,T,DEL,915,6,2,4,0.66
barcode15,5,70952050,G,DEL,972,1,0,1,0.1
barcode15,5,70952052,G,DEL,978,8,6,2,0.82
barcode15,5,70952053,G,DEL,980,1,1,0,0.1
barcode15,5,70952054,A,DEL,979,6,1,5,0.61
barcode15,5,70952055,A,DEL,964,1,0,1,0.1
barcode15,5,70952056,A,DEL,962,1,0,1,0.1
barcode15,5,70952057,A,DEL,961,1,0,1,0.1
barcode15,5,70952058,C,DEL,962,2,0,2,0.21
barcode15,5,70952059,A,DEL,963,66,0,66,6.85
barcode15,5,70952063,G,DEL,962,1,0,1,0.1
barcode15,5,70952064,T,DEL,960,40,13,27,4.17
barcode15,5,70952065,T,DEL,961,7,0,7,0.73
barcode15,5,70952068,T,DEL,960,2,0,2,0.21
barcode15,5,70952069,G,DEL,960,8,0,8,0.83
barcode15,5,70952070,A,DEL,967,5,0,5,0.52
barcode15,5,70952071,A,DEL,966,1,0,1,0.1
barcode15,5,70952072,C,DEL,969,3,2,1,0.31
barcode15,5,70952073,A,DEL,970,1,1,0,0.1
barcode15,5,70952074,T,DEL,970,11,4,7,1.13
barcode15,5,70952076,T,DEL,968,4,0,4,0.41
barcode15,5,70952077,A,DEL,976,78,2,76,7.99
barcode15,5,70952078,A,DEL,980,23,0,23,2.35
barcode15,5,70952082,G,DEL,977,2,0,2,0.2
barcode15,5,70952083,T,DEL,980,46,46,0,4.69
barcode15,5,70952084,T,DEL,984,4,4,0,0.41
barcode15,5,70952085,C,DEL,987,18,14,4,1.82
barcode15,5,70952086,A,DEL,987,27,0,27,2.74
barcode15,5,70952087,G,DEL,990,31,0,31,3.13
barcode15,5,70952091,T,DEL,995,17,16,1,1.71
barcode15,5,70952092,T,DEL,1019,1,0,1,0.1
barcode15,5,70952093,A,DEL,1028,41,4,37,3.99
barcode15,5,70952094,A,DEL,1002,3,1,2,0.3
barcode15,5,70952098,G,DEL,990,1,1,0,0.1
barcode15,5,70952099,T,DEL,992,14,14,0,1.41
barcode15,5,70952101,G,DEL,994,2,0,2,0.2
barcode15,5,70952102,A,DEL,1012,69,0,69,6.82
barcode15,5,70952107,T,DEL,1027,5,5,0,0.49
barcode15,5,70952109,A,DEL,1032,8,0,8,0.78
barcode15,5,70952111,T,DEL,1033,1,0,1,0.1
barcode15,5,70952112,G,DEL,1031,2,0,2,0.19
barcode15,5,70952113,T,DEL,1028,17,0,17,1.65
barcode15,5,70952114,A,DEL,1023,6,2,4,0.59
barcode15,5,70952118,C,DEL,1037,1,0,1,0.1
barcode15,5,70952119,A,DEL,1020,1,0,1,0.1
barcode15,5,70952123,A,DEL,989,1,0,1,0.1
barcode15,5,70952126,A,DEL,969,1,0,1,0.1
barcode15,5,70952127,T,DEL,969,13,12,1,1.34
barcode15,5,70952129,A,DEL,972,7,1,6,0.72
barcode15,5,70952132,G,DEL,965,3,3,0,0.31
barcode15,5,70952133,A,DEL,963,2,1,1,0.21
barcode15,5,70952134,A,DEL,962,1,0,1,0.1
barcode15,5,70952135,T,DEL,957,98,49,49,10.24
barcode15,5,70952143,C,DEL,947,13,11,2,1.37
barcode15,5,70952144,C,DEL,942,1,0,1,0.11
barcode15,5,70952145,A,DEL,932,3,1,2,0.32
barcode15,5,70952150,T,DEL,919,2,2,0,0.22
barcode15,5,70952151,A,DEL,917,2,2,0,0.22
barcode15,5,70952152,T,DEL,917,5,5,0,0.55
barcode15,5,70952154,A,DEL,897,4,1,3,0.45
barcode15,5,70952155,G,DEL,893,7,3,4,0.78
barcode15,5,70952158,A,DEL,882,24,21,3,2.72
barcode15,5,70952164,T,DEL,874,8,8,0,0.92
barcode15,5,70952166,A,DEL,857,1,0,1,0.12
barcode15,5,70952169,C,DEL,833,2,0,2,0.24
barcode15,5,70952170,T,DEL,833,6,0,6,0.72
barcode15,5,70952171,A,DEL,810,1,0,1,0.12
barcode15,5,70952173,A,DEL,787,1,0,1,0.13
barcode15,5,70952174,T,DEL,785,3,0,3,0.38
barcode15,5,70952175,C,DEL,778,11,10,1,1.41
barcode15,5,70952177,C,DEL,769,2,1,1,0.26
barcode15,5,70952178,T,DEL,749,6,1,5,0.8
barcode15,5,70952179,A,DEL,732,8,8,0,1.09
barcode15,5,70952182,A,DEL,705,6,6,0,0.85
barcode15,5,70952183,G,DEL,700,2,2,0,0.29
barcode15,5,70952184,A,DEL,689,1,1,0,0.15
barcode15,5,70952189,T,DEL,658,1,0,1,0.15
barcode15,5,70952190,C,DEL,647,3,0,3,0.46
barcode15,5,70952193,A,DEL,619,2,2,0,0.32
barcode15,5,70952195,T,DEL,574,7,5,2,1.22
barcode15,5,70952199,C,DEL,511,1,0,1,0.2
barcode15,5,70952200,T,DEL,510,1,1,0,0.2
barcode15,5,70952201,G,DEL,493,1,1,0,0.2
barcode15,5,70952202,G,DEL,493,1,1,0,0.2
barcode15,5,70952203,T,DEL,493,1,1,0,0.2
barcode10,5,70924860,A,DEL,149,8,0,8,5.37
barcode10,5,70924864,C,DEL,241,2,0,2,0.83
barcode10,5,70924865,A,DEL,257,3,0,3,1.17
barcode10,5,70924868,C,DEL,264,3,0,3,1.14
barcode10,5,70924869,A,DEL,268,5,0,5,1.87
barcode10,5,70924870,A,DEL,269,2,0,2,0.74
barcode10,5,70924871,A,DEL,269,5,0,5,1.86
barcode10,5,70924872,C,DEL,271,13,0,13,4.8
barcode10,5,70924873,A,DEL,271,63,3,60,23.25
barcode10,5,70924874,A,DEL,273,29,0,29,10.62
barcode10,5,70924875,A,DEL,275,15,0,15,5.45
barcode10,5,70924876,A,DEL,275,3,0,3,1.09
barcode10,5,70924877,A,DEL,275,3,0,3,1.09
barcode10,5,70924880,A,DEL,284,1,1,0,0.35
barcode10,5,70924881,A,DEL,285,1,1,0,0.35
barcode10,5,70924882,A,DEL,286,1,1,0,0.35
barcode10,5,70924883,G,DEL,288,2,1,1,0.69
barcode10,5,70924884,G,DEL,291,2,1,1,0.69
barcode10,5,70924885,A,DEL,298,10,0,10,3.36
barcode10,5,70924890,A,DEL,306,5,0,5,1.63
barcode10,5,70924891,A,DEL,308,3,0,3,0.97
barcode10,5,70924892,A,DEL,308,2,1,1,0.65
barcode10,5,70924893,T,DEL,308,2,1,1,0.65
barcode10,5,70924894,A,DEL,313,1,0,1,0.32
barcode10,5,70924895,T,DEL,313,2,0,2,0.64
barcode10,5,70924896,A,DEL,321,1,0,1,0.31
barcode10,5,70924905,A,DEL,425,7,0,7,1.65
barcode10,5,70924909,G,DEL,433,1,0,1,0.23
barcode10,5,70924910,A,DEL,444,4,0,4,0.9
barcode10,5,70924913,G,DEL,445,1,1,0,0.22
barcode10,5,70924914,G,DEL,445,1,1,0,0.22
barcode10,5,70924916,T,DEL,456,4,4,0,0.88
barcode10,5,70924917,T,DEL,457,1,1,0,0.22
barcode10,5,70924918,G,DEL,460,4,3,1,0.87
barcode10,5,70924919,A,DEL,483,4,3,1,0.83
barcode10,5,70924922,G,DEL,503,2,0,2,0.4
barcode10,5,70924923,A,DEL,509,2,1,1,0.39
barcode10,5,70924927,G,DEL,513,3,0,3,0.58
barcode10,5,70924928,A,DEL,518,30,4,26,5.79
barcode10,5,70924929,A,DEL,522,2,0,2,0.38
barcode10,5,70924930,A,DEL,523,1,1,0,0.19
barcode10,5,70924931,A,DEL,525,7,7,0,1.33
barcode10,5,70924932,A,DEL,525,8,7,1,1.52
barcode10,5,70924933,T,DEL,527,10,7,3,1.9
barcode10,5,70924935,T,DEL,542,1,0,1,0.18
barcode10,5,70924941,C,DEL,585,1,0,1,0.17
barcode10,5,70924942,C,DEL,585,1,0,1,0.17
barcode10,5,70924943,A,DEL,590,1,0,1,0.17
barcode10,5,70924944,C,DEL,595,2,0,2,0.34
barcode10,5,70924945,A,DEL,593,5,0,5,0.84
barcode10,5,70924948,T,DEL,601,1,0,1,0.17
barcode10,5,70924951,G,DEL,611,139,15,124,22.75
barcode10,5,70924952,G,DEL,618,1,0,1,0.16
barcode10,5,70924955,G,DEL,626,6,3,3,0.96
barcode10,5,70924962,A,DEL,652,4,0,4,0.61
barcode10,5,70924965,C,DEL,663,1,0,1,0.15
barcode10,5,70924966,A,DEL,665,1,0,1,0.15
barcode10,5,70924967,C,DEL,665,3,0,3,0.45
barcode10,5,70924968,T,DEL,666,12,0,12,1.8
barcode10,5,70924969,C,DEL,667,5,0,5,0.75
barcode10,5,70924970,G,DEL,667,4,0,4,0.6
barcode10,5,70924971,T,DEL,669,14,0,14,2.09
barcode10,5,70924972,A,DEL,669,6,2,4,0.9
barcode10,5,70924973,G,DEL,670,10,4,6,1.49
barcode10,5,70924974,A,DEL,684,8,0,8,1.17
barcode10,5,70924975,A,DEL,688,1,0,1,0.15
barcode10,5,70924978,C,DEL,692,1,0,1,0.14
barcode10,5,70924981,G,DEL,697,14,10,4,2.01
barcode10,5,70924982,A,DEL,697,2,0,2,0.29
barcode10,5,70924983,G,DEL,699,5,1,4,0.72
barcode10,5,70924984,A,DEL,698,5,2,3,0.72
barcode10,5,70924987,T,DEL,703,1,1,0,0.14
barcode10,5,70924988,T,DEL,702,5,5,0,0.71
barcode10,5,70924989,A,DEL,708,5,5,0,0.71
barcode10,5,70924990,C,DEL,708,5,5,0,0.71
barcode10,5,70924991,T,DEL,708,1,1,0,0.14
barcode10,5,70924993,C,DEL,720,3,2,1,0.42
barcode10,5,70924994,A,DEL,722,2,1,1,0.28
barcode10,5,70925000,T,DEL,736,25,0,25,3.4
barcode10,5,70925001,C,DEL,736,34,2,32,4.62
barcode10,5,70925002,C,DEL,739,3,0,3,0.41
barcode10,5,70925003,T,DEL,743,2,0,2,0.27
barcode10,5,70925004,C,DEL,753,73,49,24,9.69
barcode10,5,70925006,C,DEL,763,1,1,0,0.13
barcode10,5,70925007,G,DEL,766,1,1,0,0.13
barcode10,5,70925012,C,DEL,774,1,0,1,0.13
barcode10,5,70925014,G,DEL,776,1,0,1,0.13
barcode10,5,70925015,T,DEL,775,1,0,1,0.13
barcode10,5,70925020,T,DEL,779,36,2,34,4.62
barcode10,5,70925022,C,DEL,790,6,1,5,0.76
barcode10,5,70925025,C,DEL,791,3,1,2,0.38
barcode10,5,70925026,T,DEL,795,1,1,0,0.13
barcode10,5,70925027,C,DEL,800,131,125,6,16.38
barcode10,5,70925030,A,DEL,807,4,2,2,0.5
barcode10,5,70925031,G,DEL,808,2,0,2,0.25
barcode10,5,70925032,A,DEL,808,3,1,2,0.37
barcode10,5,70925035,C,DEL,809,108,77,31,13.35
barcode10,5,70925036,C,DEL,808,1,1,0,0.12
barcode10,5,70925038,C,DEL,808,13,12,1,1.61
barcode10,5,70925039,G,DEL,809,37,22,15,4.57
barcode10,5,70925040,G,DEL,808,2,2,0,0.25
barcode10,5,70925041,G,DEL,809,2,2,0,0.25
barcode10,5,70925042,C,DEL,807,1,1,0,0.12
barcode10,5,70925046,G,DEL,810,6,5,1,0.74
barcode10,5,70925047,G,DEL,812,1,0,1,0.12
barcode10,5,70925048,A,DEL,813,61,1,60,7.5
barcode10,5,70925054,T,DEL,808,2,0,2,0.25
barcode10,5,70925055,C,DEL,807,2,0,2,0.25
barcode10,5,70925058,T,DEL,808,1,1,0,0.12
barcode10,5,70925059,C,DEL,807,3,1,2,0.37
barcode10,5,70925060,T,DEL,808,43,30,13,5.32
barcode10,5,70925061,T,DEL,806,6,2,4,0.74
barcode10,5,70925062,A,DEL,805,22,3,19,2.73
barcode10,5,70925063,A,DEL,805,2,2,0,0.25
barcode10,5,70925064,G,DEL,806,3,2,1,0.37
barcode10,5,70925065,A,DEL,810,16,9,7,1.98
barcode10,5,70925066,A,DEL,809,6,5,1,0.74
barcode10,5,70925067,G,DEL,809,26,20,6,3.21
barcode10,5,70925068,G,DEL,807,3,3,0,0.37
barcode10,5,70925071,C,DEL,800,1,1,0,0.12
barcode10,5,70925072,G,DEL,798,36,31,5,4.51
barcode10,5,70925074,G,DEL,790,1,1,0,0.13
barcode10,5,70925075,G,DEL,781,35,35,0,4.48
barcode10,5,70925076,C,DEL,779,56,52,4,7.19
barcode10,5,70925077,C,DEL,780,23,19,4,2.95
barcode10,5,70925078,C,DEL,778,21,20,1,2.7
barcode10,5,70925079,C,DEL,784,11,10,1,1.4
barcode10,5,70925080,A,DEL,785,13,12,1,1.66
barcode10,5,70925081,C,DEL,785,2,1,1,0.25
barcode10,5,70925082,G,DEL,784,1,1,0,0.13
barcode10,5,70925083,C,DEL,786,1,1,0,0.13
barcode10,5,70925084,T,DEL,786,3,2,1,0.38
barcode10,5,70925085,G,DEL,786,4,4,0,0.51
barcode10,5,70925086,C,DEL,789,4,4,0,0.51
barcode10,5,70925088,C,DEL,787,2,1,1,0.25
barcode10,5,70925089,A,DEL,790,3,1,2,0.38
barcode10,5,70925090,C,DEL,787,18,17,1,2.29
barcode10,5,70925092,C,DEL,785,3,3,0,0.38
barcode10,5,70925093,G,DEL,793,5,5,0,0.63
barcode10,5,70925094,C,DEL,794,1,1,0,0.13
barcode10,5,70925095,G,DEL,792,8,2,6,1.01
barcode10,5,70925098,T,DEL,788,3,3,0,0.38
barcode10,5,70925099,T,DEL,780,1,1,0,0.13
barcode10,5,70925100,T,DEL,780,1,1,0,0.13
barcode10,5,70925101,G,DEL,781,2,2,0,0.26
barcode10,5,70925102,C,DEL,781,2,2,0,0.26
barcode10,5,70925108,C,DEL,783,1,0,1,0.13
barcode10,5,70925109,G,DEL,781,2,0,2,0.26
barcode10,5,70925110,A,DEL,781,2,0,2,0.26
barcode10,5,70925113,A,DEL,777,1,1,0,0.13
barcode10,5,70925114,G,DEL,777,7,1,6,0.9
barcode10,5,70925115,C,DEL,780,7,1,6,0.9
barcode10,5,70925119,G,DEL,780,1,0,1,0.13
barcode10,5,70925124,C,DEL,754,1,0,1,0.13
barcode10,5,70925125,A,DEL,747,4,4,0,0.54
barcode10,5,70925126,G,DEL,747,6,5,1,0.8
barcode10,5,70925127,T,DEL,747,5,4,1,0.67
barcode10,5,70925128,G,DEL,746,2,1,1,0.27
barcode10,5,70925131,G,DEL,740,1,1,0,0.14
barcode10,5,70925132,G,DEL,738,1,1,0,0.14
barcode10,5,70925133,C,DEL,734,1,1,0,0.14
barcode10,5,70925135,G,DEL,729,1,0,1,0.14
barcode10,5,70925136,C,DEL,722,1,0,1,0.14
barcode10,5,70925137,G,DEL,722,1,0,1,0.14
barcode10,5,70925139,C,DEL,719,22,20,2,3.06
barcode10,5,70925140,C,DEL,720,1,0,1,0.14
barcode10,5,70925141,C,DEL,720,2,2,0,0.28
barcode10,5,70925142,G,DEL,720,10,9,1,1.39
barcode10,5,70925143,G,DEL,719,2,0,2,0.28
barcode10,5,70925144,A,DEL,714,3,2,1,0.42
barcode10,5,70925145,G,DEL,711,13,4,9,1.83
barcode10,5,70925146,C,DEL,708,6,5,1,0.85
barcode10,5,70925147,A,DEL,702,17,17,0,2.42
barcode10,5,70925148,G,DEL,702,11,11,0,1.57
barcode10,5,70925149,G,DEL,698,9,9,0,1.29
barcode10,5,70925150,A,DEL,695,2,2,0,0.29
barcode10,5,70925151,G,DEL,694,7,7,0,1.01
barcode10,5,70925152,G,DEL,690,11,11,0,1.59
barcode10,5,70925153,A,DEL,690,12,12,0,1.74
barcode10,5,70925154,T,DEL,689,23,23,0,3.34
barcode10,5,70925155,T,DEL,684,1,0,1,0.15
barcode10,5,70925156,C,DEL,684,3,1,2,0.44
barcode10,5,70925157,C,DEL,683,1,0,1,0.15
barcode10,5,70925158,G,DEL,683,1,1,0,0.15
barcode10,5,70925159,T,DEL,680,1,1,0,0.15
barcode10,5,70925160,G,DEL,659,1,1,0,0.15
barcode10,5,70925161,C,DEL,657,1,0,1,0.15
barcode10,5,70925162,T,DEL,657,2,0,2,0.3
barcode10,5,70925163,G,DEL,657,1,0,1,0.15
barcode10,5,70925164,T,DEL,651,11,8,3,1.69
barcode10,5,70925166,C,DEL,637,5,1,4,0.78
barcode10,5,70925167,C,DEL,633,6,1,5,0.95
barcode10,5,70925168,G,DEL,630,14,3,11,2.22
barcode10,5,70925169,G,DEL,627,1,1,0,0.16
barcode10,5,70925172,C,DEL,603,1,1,0,0.17
barcode10,5,70925173,G,DEL,600,2,2,0,0.33
barcode10,5,70925176,A,DEL,586,1,1,0,0.17
barcode10,5,70925177,C,DEL,584,2,1,1,0.34
barcode10,5,70925178,A,DEL,584,5,5,0,0.86
barcode10,5,70925179,G,DEL,584,1,1,0,0.17
barcode10,5,70925181,C,DEL,578,11,11,0,1.9
barcode10,5,70925183,A,DEL,577,1,1,0,0.17
barcode10,5,70925187,G,DEL,563,1,1,0,0.18
barcode10,5,70925188,A,DEL,559,1,1,0,0.18
barcode10,5,70925192,C,DEL,548,2,2,0,0.36
barcode10,5,70925193,G,DEL,546,3,2,1,0.55
barcode10,5,70925196,G,DEL,539,1,1,0,0.19
barcode10,5,70925197,C,DEL,533,6,6,0,1.13
barcode10,5,70925198,C,DEL,528,1,1,0,0.19
barcode10,5,70925199,A,DEL,519,1,1,0,0.19
barcode10,5,70925202,G,DEL,506,2,2,0,0.4
barcode10,5,70925203,C,DEL,493,1,1,0,0.2
barcode10,5,70925205,G,DEL,482,1,1,0,0.21
barcode10,5,70925206,T,DEL,480,1,1,0,0.21
barcode10,5,70925207,C,DEL,465,7,1,6,1.51
barcode10,5,70925208,T,DEL,455,2,1,1,0.44
barcode10,5,70925209,C,DEL,447,3,3,0,0.67
barcode10,5,70925213,A,DEL,204,3,3,0,1.47
barcode10,5,70938766,T,DEL,625,1,0,1,0.16
barcode10,5,70938767,C,DEL,670,20,0,20,2.99
barcode10,5,70938768,T,DEL,777,44,3,41,5.66
barcode10,5,70938769,T,DEL,788,2,0,2,0.25
barcode10,5,70938770,G,DEL,793,8,0,8,1.01
barcode10,5,70938772,T,DEL,813,13,0,13,1.6
barcode10,5,70938774,C,DEL,841,2,1,1,0.24
barcode10,5,70938775,T,DEL,847,5,0,5,0.59
barcode10,5,70938776,A,DEL,863,12,0,12,1.39
barcode10,5,70938780,T,DEL,894,2,0,2,0.22
barcode10,5,70938781,A,DEL,897,8,8,0,0.89
barcode10,5,70938782,C,DEL,900,2,0,2,0.22
barcode10,5,70938783,A,DEL,906,11,0,11,1.21
barcode10,5,70938784,T,DEL,908,43,22,21,4.74
barcode10,5,70938785,T,DEL,912,9,0,9,0.99
barcode10,5,70938786,T,DEL,921,2,2,0,0.22
barcode10,5,70938787,T,DEL,931,6,4,2,0.64
barcode10,5,70938788,C,DEL,950,12,5,7,1.26
barcode10,5,70938789,T,DEL,951,3,0,3,0.32
barcode10,5,70938790,G,DEL,957,28,0,28,2.93
barcode10,5,70938791,A,DEL,965,1,0,1,0.1
barcode10,5,70938792,T,DEL,966,5,5,0,0.52
barcode10,5,70938794,A,DEL,966,34,0,34,3.52
barcode10,5,70938799,T,DEL,1069,2,1,1,0.19
barcode10,5,70938800,A,DEL,1085,2,2,0,0.18
barcode10,5,70938801,T,DEL,1096,5,0,5,0.46
barcode10,5,70938802,C,DEL,1133,2,1,1,0.18
barcode10,5,70938803,T,DEL,1137,2,1,1,0.18
barcode10,5,70938804,G,DEL,1140,27,0,27,2.37
barcode10,5,70938805,A,DEL,1147,20,0,20,1.74
barcode10,5,70938806,A,DEL,1163,1,0,1,0.09
barcode10,5,70938807,C,DEL,1235,2,1,1,0.16
barcode10,5,70938808,A,DEL,1254,2,0,2,0.16
barcode10,5,70938809,T,DEL,1259,1,0,1,0.08
barcode10,5,70938810,G,DEL,1293,1,1,0,0.08
barcode10,5,70938811,A,DEL,1314,1,1,0,0.08
barcode10,5,70938812,G,DEL,1318,1,1,0,0.08
barcode10,5,70938813,T,DEL,1349,1,1,0,0.07
barcode10,5,70938814,T,DEL,1349,5,5,0,0.37
barcode10,5,70938815,G,DEL,1365,7,7,0,0.51
barcode10,5,70938816,T,DEL,1372,145,91,54,10.57
barcode10,5,70938817,T,DEL,1375,60,59,1,4.36
barcode10,5,70938818,T,DEL,1379,10,9,1,0.73
barcode10,5,70938819,T,DEL,1381,11,10,1,0.8
barcode10,5,70938820,T,DEL,1380,11,10,1,0.8
barcode10,5,70938821,A,DEL,1385,16,16,0,1.16
barcode10,5,70938822,T,DEL,1387,14,6,8,1.01
barcode10,5,70938823,T,DEL,1400,5,5,0,0.36
barcode10,5,70938824,T,DEL,1399,5,5,0,0.36
barcode10,5,70938825,C,DEL,1422,8,7,1,0.56
barcode10,5,70938826,T,DEL,1427,22,21,1,1.54
barcode10,5,70938827,T,DEL,1430,1,0,1,0.07
barcode10,5,70938828,A,DEL,1453,5,4,1,0.34
barcode10,5,70938829,C,DEL,1455,23,3,20,1.58
barcode10,5,70938831,C,DEL,1459,4,4,0,0.27
barcode10,5,70938832,T,DEL,1459,35,31,4,2.4
barcode10,5,70938835,C,DEL,1490,7,5,2,0.47
barcode10,5,70938836,C,DEL,1499,2,2,0,0.13
barcode10,5,70938837,A,DEL,1499,6,5,1,0.4
barcode10,5,70938838,G,DEL,1507,7,6,1,0.46
barcode10,5,70938839,A,DEL,1519,1,1,0,0.07
barcode10,5,70938847,T,DEL,1499,8,7,1,0.53
barcode10,5,70938848,T,DEL,1500,8,8,0,0.53
barcode10,5,70938849,C,DEL,1508,9,8,1,0.6
barcode10,5,70938850,T,DEL,1507,2,1,1,0.13
barcode10,5,70938851,G,DEL,1509,14,0,14,0.93
barcode10,5,70938852,A,DEL,1511,3,0,3,0.2
barcode10,5,70938853,C,DEL,1511,3,0,3,0.2
barcode10,5,70938854,A,DEL,1504,1,1,0,0.07
barcode10,5,70938855,T,DEL,1503,17,14,3,1.13
barcode10,5,70938857,T,DEL,1508,1,0,1,0.07
barcode10,5,70938858,G,DEL,1520,69,8,61,4.54
barcode10,5,70938861,A,DEL,1514,1,0,1,0.07
barcode10,5,70938862,T,DEL,1514,1,1,0,0.07
barcode10,5,70938864,A,DEL,1517,12,0,12,0.79
barcode10,5,70938865,T,DEL,1497,11,0,11,0.73
barcode10,5,70938866,A,DEL,1527,5,5,0,0.33
barcode10,5,70938867,C,DEL,1528,1,1,0,0.07
barcode10,5,70938868,A,DEL,1524,2,2,0,0.13
barcode10,5,70938869,G,DEL,1529,10,0,10,0.65
barcode10,5,70938870,C,DEL,1534,1,0,1,0.07
barcode10,5,70938872,C,DEL,1495,2,2,0,0.13
barcode10,5,70938873,T,DEL,1486,4,2,2,0.27
barcode10,5,70938874,G,DEL,1468,3,2,1,0.2
barcode10,5,70938875,A,DEL,1469,3,2,1,0.2
barcode10,5,70938876,T,DEL,1468,3,1,2,0.2
barcode10,5,70938877,A,DEL,1422,54,46,8,3.8
barcode10,5,70938879,A,DEL,1416,1,1,0,0.07
barcode10,5,70938880,A,DEL,1409,1,1,0,0.07
barcode10,5,70938881,G,DEL,1405,1,1,0,0.07
barcode10,5,70938882,C,DEL,1401,1,1,0,0.07
barcode10,5,70938885,A,DEL,1389,1,1,0,0.07
barcode10,5,70938886,T,DEL,1389,1,1,0,0.07
barcode10,5,70938887,G,DEL,1381,1,1,0,0.07
barcode10,5,70938889,T,DEL,1367,1,1,0,0.07
barcode10,5,70938890,A,DEL,1347,11,6,5,0.82
barcode10,5,70938891,A,DEL,1347,1,0,1,0.07
barcode10,5,70938893,G,DEL,1338,1,1,0,0.07
barcode10,5,70938898,G,DEL,1272,1,0,1,0.08
barcode10,5,70938900,C,DEL,1232,6,0,6,0.49
barcode10,5,70938901,T,DEL,1231,10,10,0,0.81
barcode10,5,70938902,T,DEL,1202,2,2,0,0.17
barcode10,5,70938903,C,DEL,1177,4,4,0,0.34
barcode10,5,70938904,A,DEL,1174,3,3,0,0.26
barcode10,5,70938905,T,DEL,1174,14,2,12,1.19
barcode10,5,70938907,T,DEL,1164,3,1,2,0.26
barcode10,5,70938908,A,DEL,1161,20,2,18,1.72
barcode10,5,70938912,T,DEL,1128,2,0,2,0.18
barcode10,5,70938913,A,DEL,1113,4,2,2,0.36
barcode10,5,70938915,G,DEL,1096,1,1,0,0.09
barcode10,5,70938916,A,DEL,1085,6,1,5,0.55
barcode10,5,70938918,A,DEL,1060,1,1,0,0.09
barcode10,5,70938919,T,DEL,1052,29,29,0,2.76
barcode10,5,70938920,G,DEL,1044,30,30,0,2.87
barcode10,5,70938921,C,DEL,1041,30,29,1,2.88
barcode10,5,70938922,T,DEL,1041,29,29,0,2.79
barcode10,5,70938923,T,DEL,1036,4,4,0,0.39
barcode10,5,70938924,G,DEL,1027,6,6,0,0.58
barcode10,5,70938925,C,DEL,1000,7,4,3,0.7
barcode10,5,70938926,T,DEL,996,3,3,0,0.3
barcode10,5,70938929,G,DEL,965,2,2,0,0.21
barcode10,5,70938931,C,DEL,939,4,4,0,0.43
barcode10,5,70938932,G,DEL,938,1,1,0,0.11
barcode10,5,70938933,T,DEL,938,46,45,1,4.9
barcode10,5,70938934,T,DEL,938,1,0,1,0.11
barcode10,5,70938935,T,DEL,930,2,2,0,0.22
barcode10,5,70938936,T,DEL,922,4,4,0,0.43
barcode10,5,70938937,C,DEL,913,5,5,0,0.55
barcode10,5,70938941,T,DEL,904,102,102,0,11.28
barcode10,5,70938943,T,DEL,902,2,2,0,0.22
barcode10,5,70938944,T,DEL,881,5,5,0,0.57
barcode10,5,70938945,C,DEL,870,9,9,0,1.03
barcode10,5,70941356,G,DEL,109,1,0,1,0.92
barcode10,5,70941358,A,DEL,282,2,0,2,0.71
barcode10,5,70941364,T,DEL,407,1,0,1,0.25
barcode10,5,70941366,C,DEL,417,1,0,1,0.24
barcode10,5,70941368,T,DEL,426,103,1,102,24.18
barcode10,5,70941369,T,DEL,436,4,0,4,0.92
barcode10,5,70941374,T,DEL,448,1,0,1,0.22
barcode10,5,70941376,C,DEL,462,1,0,1,0.22
barcode10,5,70941377,C,DEL,463,4,0,4,0.86
barcode10,5,70941378,T,DEL,464,14,1,13,3.02
barcode10,5,70941379,A,DEL,469,1,1,0,0.21
barcode10,5,70941380,T,DEL,479,20,4,16,4.18
barcode10,5,70941381,T,DEL,485,1,0,1,0.21
barcode10,5,70941383,T,DEL,504,9,0,9,1.79
barcode10,5,70941384,C,DEL,520,72,0,72,13.85
barcode10,5,70941386,T,DEL,533,39,0,39,7.32
barcode10,5,70941387,A,DEL,539,1,0,1,0.19
barcode10,5,70941388,G,DEL,542,1,0,1,0.18
barcode10,5,70941390,A,DEL,549,1,1,0,0.18
barcode10,5,70941393,C,DEL,566,1,1,0,0.18
barcode10,5,70941394,T,DEL,593,1,1,0,0.17
barcode10,5,70941395,C,DEL,626,3,0,3,0.48
barcode10,5,70941396,T,DEL,632,26,1,25,4.11
barcode10,5,70941397,A,DEL,644,38,1,37,5.9
barcode10,5,70941398,A,DEL,651,2,1,1,0.31
barcode10,5,70941399,A,DEL,652,2,1,1,0.31
barcode10,5,70941400,G,DEL,656,4,2,2,0.61
barcode10,5,70941401,A,DEL,672,4,3,1,0.6
barcode10,5,70941402,A,DEL,673,1,0,1,0.15
barcode10,5,70941403,T,DEL,677,1,0,1,0.15
barcode10,5,70941404,G,DEL,682,1,0,1,0.15
barcode10,5,70941408,A,DEL,720,10,0,10,1.39
barcode10,5,70941409,C,DEL,728,1,1,0,0.14
barcode10,5,70941411,T,DEL,751,9,9,0,1.2
barcode10,5,70941412,T,DEL,755,1,1,0,0.13
barcode10,5,70941413,T,DEL,757,10,10,0,1.32
barcode10,5,70941414,G,DEL,766,20,20,0,2.61
barcode10,5,70941416,G,DEL,772,2,0,2,0.26
barcode10,5,70941417,A,DEL,775,35,6,29,4.52
barcode10,5,70941420,C,DEL,778,2,0,2,0.26
barcode10,5,70941421,T,DEL,807,32,32,0,3.97
barcode10,5,70941423,C,DEL,852,13,13,0,1.53
barcode10,5,70941424,G,DEL,884,27,2,25,3.05
barcode10,5,70941425,G,DEL,892,1,0,1,0.11
barcode10,5,70941426,G,DEL,891,2,0,2,0.22
barcode10,5,70941427,T,DEL,895,6,0,6,0.67
barcode10,5,70941428,A,DEL,891,16,3,13,1.8
barcode10,5,70941429,A,DEL,897,1,0,1,0.11
barcode10,5,70941430,A,DEL,899,1,0,1,0.11
barcode10,5,70941431,C,DEL,900,21,18,3,2.33
barcode10,5,70941432,C,DEL,904,2,0,2,0.22
barcode10,5,70941433,A,DEL,905,89,14,75,9.83
barcode10,5,70941434,A,DEL,908,5,1,4,0.55
barcode10,5,70941435,A,DEL,908,1,0,1,0.11
barcode10,5,70941437,A,DEL,910,1,0,1,0.11
barcode10,5,70941438,C,DEL,911,1,0,1,0.11
barcode10,5,70941439,C,DEL,915,2,2,0,0.22
barcode10,5,70941440,A,DEL,919,3,2,1,0.33
barcode10,5,70941443,C,DEL,928,4,0,4,0.43
barcode10,5,70941444,C,DEL,929,1,0,1,0.11
barcode10,5,70941445,T,DEL,931,3,0,3,0.32
barcode10,5,70941446,A,DEL,933,69,23,46,7.4
barcode10,5,70941447,A,DEL,931,1,1,0,0.11
barcode10,5,70941448,A,DEL,930,1,1,0,0.11
barcode10,5,70941449,A,DEL,926,1,1,0,0.11
barcode10,5,70941450,G,DEL,925,2,1,1,0.22
barcode10,5,70941451,A,DEL,926,13,4,9,1.4
barcode10,5,70941455,C,DEL,939,1,1,0,0.11
barcode10,5,70941456,C,DEL,941,2,2,0,0.21
barcode10,5,70941457,T,DEL,940,2,1,1,0.21
barcode10,5,70941458,G,DEL,942,5,5,0,0.53
barcode10,5,70941459,C,DEL,946,1,1,0,0.11
barcode10,5,70941460,T,DEL,946,1,1,0,0.11
barcode10,5,70941461,A,DEL,939,39,37,2,4.15
barcode10,5,70941462,A,DEL,935,25,23,2,2.67
barcode10,5,70941463,G,DEL,931,25,23,2,2.69
barcode10,5,70941464,A,DEL,930,23,22,1,2.47
barcode10,5,70941465,A,DEL,932,29,28,1,3.11
barcode10,5,70941466,G,DEL,930,34,32,2,3.66
barcode10,5,70941467,A,DEL,929,14,10,4,1.51
barcode10,5,70941468,A,DEL,930,6,0,6,0.65
barcode10,5,70941469,T,DEL,930,8,1,7,0.86
barcode10,5,70941470,A,DEL,923,34,13,21,3.68
barcode10,5,70941471,A,DEL,924,1,0,1,0.11
barcode10,5,70941475,C,DEL,928,5,5,0,0.54
barcode10,5,70941476,C,DEL,926,1,0,1,0.11
barcode10,5,70941477,A,DEL,927,107,33,74,11.54
barcode10,5,70941478,A,DEL,926,8,0,8,0.86
barcode10,5,70941479,A,DEL,917,7,6,1,0.76
barcode10,5,70941480,A,DEL,905,9,6,3,0.99
barcode10,5,70941481,G,DEL,904,9,6,3,1.0
barcode10,5,70941482,A,DEL,901,21,1,20,2.33
barcode10,5,70941483,A,DEL,900,14,14,0,1.56
barcode10,5,70941484,G,DEL,897,18,18,0,2.01
barcode10,5,70941485,A,DEL,887,42,38,4,4.74
barcode10,5,70941487,T,DEL,885,1,1,0,0.11
barcode10,5,70941488,A,DEL,885,5,3,2,0.56
barcode10,5,70941489,C,DEL,884,3,3,0,0.34
barcode10,5,70941494,G,DEL,856,1,0,1,0.12
barcode10,5,70941495,C,DEL,843,16,0,16,1.9
barcode10,5,70941496,T,DEL,845,45,41,4,5.33
barcode10,5,70941500,T,DEL,812,70,69,1,8.62
barcode10,5,70941502,A,DEL,791,14,14,0,1.77
barcode10,5,70941507,A,DEL,751,1,1,0,0.13
barcode10,5,70941513,T,DEL,710,29,28,1,4.08
barcode10,5,70941517,A,DEL,698,8,7,1,1.15
barcode10,5,70941520,A,DEL,690,1,1,0,0.14
barcode10,5,70941521,T,DEL,687,2,2,0,0.29
barcode10,5,70941523,T,DEL,685,68,68,0,9.93
barcode10,5,70941524,T,DEL,683,3,3,0,0.44
barcode10,5,70941525,G,DEL,678,11,10,1,1.62
barcode10,5,70941527,G,DEL,667,5,5,0,0.75
barcode10,5,70941528,A,DEL,656,1,1,0,0.15
barcode10,5,70941529,T,DEL,656,24,23,1,3.66
barcode10,5,70941532,A,DEL,648,1,1,0,0.15
barcode10,5,70941535,T,DEL,641,35,35,0,5.46
barcode10,5,70941538,A,DEL,609,2,0,2,0.33
barcode10,5,70941541,G,DEL,592,1,1,0,0.17
barcode10,5,70942312,T,DEL,28,1,1,0,3.57
barcode10,5,70942315,A,DEL,124,1,1,0,0.81
barcode10,5,70942327,T,DEL,219,1,0,1,0.46
barcode10,5,70942328,G,DEL,222,1,0,1,0.45
barcode10,5,70942329,C,DEL,233,1,0,1,0.43
barcode10,5,70942331,T,DEL,236,1,0,1,0.42
barcode10,5,70942332,G,DEL,237,1,0,1,0.42
barcode10,5,70942333,T,DEL,237,13,1,12,5.49
barcode10,5,70942334,A,DEL,241,7,1,6,2.9
barcode10,5,70942335,T,DEL,241,1,0,1,0.41
barcode10,5,70942336,A,DEL,243,1,0,1,0.41
barcode10,5,70942337,T,DEL,243,2,0,2,0.82
barcode10,5,70942338,A,DEL,244,2,0,2,0.82
barcode10,5,70942339,T,DEL,244,5,0,5,2.05
barcode10,5,70942340,C,DEL,244,1,0,1,0.41
barcode10,5,70942341,T,DEL,244,22,14,8,9.02
barcode10,5,70942342,T,DEL,317,1,0,1,0.32
barcode10,5,70942343,T,DEL,317,1,0,1,0.32
barcode10,5,70942344,G,DEL,318,6,0,6,1.89
barcode10,5,70942345,A,DEL,318,1,0,1,0.31
barcode10,5,70942346,T,DEL,318,2,1,1,0.63
barcode10,5,70942350,T,DEL,328,37,16,21,11.28
barcode10,5,70942355,T,DEL,499,1,0,1,0.2
barcode10,5,70942359,G,DEL,570,3,3,0,0.53
barcode10,5,70942361,A,DEL,572,49,8,41,8.57
barcode10,5,70942366,T,DEL,591,1,0,1,0.17
barcode10,5,70942367,G,DEL,595,42,9,33,7.06
barcode10,5,70942368,G,DEL,600,1,1,0,0.17
barcode10,5,70942369,G,DEL,601,1,0,1,0.17
barcode10,5,70942370,G,DEL,604,3,0,3,0.5
barcode10,5,70942371,A,DEL,605,5,0,5,0.83
barcode10,5,70942372,C,DEL,605,4,0,4,0.66
barcode10,5,70942373,A,DEL,607,11,2,9,1.81
barcode10,5,70942375,A,DEL,607,1,1,0,0.16
barcode10,5,70942376,T,DEL,608,2,2,0,0.33
barcode10,5,70942377,G,DEL,608,2,2,0,0.33
barcode10,5,70942378,T,DEL,614,3,2,1,0.49
barcode10,5,70942379,T,DEL,616,7,7,0,1.14
barcode10,5,70942380,C,DEL,620,10,8,2,1.61
barcode10,5,70942381,T,DEL,620,2,1,1,0.32
barcode10,5,70942382,G,DEL,623,7,7,0,1.12
barcode10,5,70942383,C,DEL,625,10,10,0,1.6
barcode10,5,70942384,C,DEL,629,1,1,0,0.16
barcode10,5,70942385,A,DEL,631,1,1,0,0.16
barcode10,5,70942386,T,DEL,633,68,67,1,10.74
barcode10,5,70942387,T,DEL,637,8,8,0,1.26
barcode10,5,70942388,T,DEL,638,5,5,0,0.78
barcode10,5,70942389,G,DEL,638,6,5,1,0.94
barcode10,5,70942390,G,DEL,641,5,5,0,0.78
barcode10,5,70942391,T,DEL,645,1,1,0,0.16
barcode10,5,70942392,C,DEL,645,12,12,0,1.86
barcode10,5,70942393,A,DEL,650,12,1,11,1.85
barcode10,5,70942394,G,DEL,652,13,1,12,1.99
barcode10,5,70942395,A,DEL,655,2,2,0,0.31
barcode10,5,70942398,A,DEL,657,28,28,0,4.26
barcode10,5,70942399,C,DEL,658,1,1,0,0.15
barcode10,5,70942402,T,DEL,661,63,63,0,9.53
barcode10,5,70942403,T,DEL,661,1,1,0,0.15
barcode10,5,70942404,G,DEL,666,1,0,1,0.15
barcode10,5,70942405,C,DEL,666,2,1,1,0.3
barcode10,5,70942406,A,DEL,665,2,2,0,0.3
barcode10,5,70942407,T,DEL,665,33,28,5,4.96
barcode10,5,70942408,T,DEL,691,2,2,0,0.29
barcode10,5,70942411,C,DEL,714,16,16,0,2.24
barcode10,5,70942418,A,DEL,713,9,9,0,1.26
barcode10,5,70942419,C,DEL,713,6,6,0,0.84
barcode10,5,70942420,C,DEL,716,3,3,0,0.42
barcode10,5,70942422,T,DEL,725,3,3,0,0.41
barcode10,5,70942423,T,DEL,726,2,2,0,0.28
barcode10,5,70942424,G,DEL,741,3,3,0,0.4
barcode10,5,70942425,C,DEL,743,3,3,0,0.4
barcode10,5,70942426,T,DEL,748,17,17,0,2.27
barcode10,5,70942433,G,DEL,777,1,1,0,0.13
barcode10,5,70942435,T,DEL,776,22,20,2,2.84
barcode10,5,70942436,T,DEL,773,2,2,0,0.26
barcode10,5,70942437,T,DEL,769,22,22,0,2.86
barcode10,5,70942438,T,DEL,766,77,75,2,10.05
barcode10,5,70942439,A,DEL,768,134,128,6,17.45
barcode10,5,70942440,A,DEL,768,81,81,0,10.55
barcode10,5,70942441,G,DEL,769,62,62,0,8.06
barcode10,5,70942442,A,DEL,775,38,38,0,4.9
barcode10,5,70942443,G,DEL,776,2,1,1,0.26
barcode10,5,70942444,A,DEL,777,7,7,0,0.9
barcode10,5,70942445,G,DEL,777,12,11,1,1.54
barcode10,5,70942446,A,DEL,773,8,8,0,1.03
barcode10,5,70942447,A,DEL,781,1,1,0,0.13
barcode10,5,70942449,C,DEL,782,1,1,0,0.13
barcode10,5,70942451,T,DEL,796,7,7,0,0.88
barcode10,5,70942452,G,DEL,796,8,8,0,1.01
barcode10,5,70942453,T,DEL,794,1,1,0,0.13
barcode10,5,70942454,G,DEL,795,2,1,1,0.25
barcode10,5,70942455,T,DEL,792,1,1,0,0.13
barcode10,5,70942459,G,DEL,802,2,2,0,0.25
barcode10,5,70942461,T,DEL,800,2,2,0,0.25
barcode10,5,70942464,A,DEL,803,2,1,1,0.25
barcode10,5,70942469,G,DEL,831,1,0,1,0.12
barcode10,5,70942477,A,DEL,817,2,0,2,0.24
barcode10,5,70942480,T,DEL,814,1,1,0,0.12
barcode10,5,70942481,A,DEL,801,23,22,1,2.87
barcode10,5,70942482,G,DEL,797,6,5,1,0.75
barcode10,5,70942483,A,DEL,796,10,10,0,1.26
barcode10,5,70942484,G,DEL,793,11,11,0,1.39
barcode10,5,70942485,A,DEL,793,12,12,0,1.51
barcode10,5,70942486,G,DEL,790,64,64,0,8.1
barcode10,5,70942487,G,DEL,787,10,10,0,1.27
barcode10,5,70942488,A,DEL,786,7,7,0,0.89
barcode10,5,70942489,G,DEL,786,6,5,1,0.76
barcode10,5,70942490,C,DEL,787,3,3,0,0.38
barcode10,5,70942491,A,DEL,783,9,7,2,1.15
barcode10,5,70942494,A,DEL,780,5,1,4,0.64
barcode10,5,70942495,T,DEL,777,11,4,7,1.42
barcode10,5,70942496,C,DEL,769,7,4,3,0.91
barcode10,5,70942497,T,DEL,770,2,2,0,0.26
barcode10,5,70942498,G,DEL,767,3,3,0,0.39
barcode10,5,70942499,T,DEL,766,10,9,1,1.31
barcode10,5,70942500,C,DEL,766,8,8,0,1.04
barcode10,5,70942501,C,DEL,767,5,5,0,0.65
barcode10,5,70942502,G,DEL,766,10,5,5,1.31
barcode10,5,70942504,T,DEL,763,3,3,0,0.39
barcode10,5,70942505,C,DEL,758,3,3,0,0.4
barcode10,5,70942506,T,DEL,757,5,1,4,0.66
barcode10,5,70942507,A,DEL,756,4,4,0,0.53
barcode10,5,70942508,C,DEL,759,8,8,0,1.05
barcode10,5,70942509,T,DEL,761,29,20,9,3.81
barcode10,5,70942510,T,DEL,767,6,1,5,0.78
barcode10,5,70942511,T,DEL,767,101,92,9,13.17
barcode10,5,70942512,C,DEL,768,309,296,13,40.23
barcode10,5,70942513,C,DEL,819,22,22,0,2.69
barcode10,5,70942514,C,DEL,819,2,2,0,0.24
barcode10,5,70942515,C,DEL,818,1,1,0,0.12
barcode10,5,70942516,A,DEL,818,2,2,0,0.24
barcode10,5,70942517,A,DEL,819,2,2,0,0.24
barcode10,5,70942518,T,DEL,819,2,2,0,0.24
barcode10,5,70942519,C,DEL,845,5,5,0,0.59
barcode10,5,70942522,T,DEL,845,3,2,1,0.36
barcode10,5,70942523,G,DEL,844,1,0,1,0.12
barcode10,5,70942524,A,DEL,844,4,0,4,0.47
barcode10,5,70942526,G,DEL,838,4,4,0,0.48
barcode10,5,70942528,A,DEL,828,1,1,0,0.12
barcode10,5,70942529,G,DEL,827,1,1,0,0.12
barcode10,5,70942534,T,DEL,811,1,1,0,0.12
barcode10,5,70942535,A,DEL,804,2,1,1,0.25
barcode10,5,70942536,A,DEL,803,1,1,0,0.12
barcode10,5,70942537,T,DEL,803,1,1,0,0.12
barcode10,5,70942538,A,DEL,795,1,1,0,0.13
barcode10,5,70942539,T,DEL,793,2,2,0,0.25
barcode10,5,70942540,A,DEL,786,2,2,0,0.25
barcode10,5,70942541,G,DEL,780,9,9,0,1.15
barcode10,5,70942542,A,DEL,779,3,1,2,0.39
barcode10,5,70942545,A,DEL,774,2,0,2,0.26
barcode10,5,70942554,A,DEL,755,1,1,0,0.13
barcode10,5,70942557,A,DEL,744,22,22,0,2.96
barcode10,5,70942558,G,DEL,735,1,1,0,0.14
barcode10,5,70942559,G,DEL,732,1,1,0,0.14
barcode10,5,70942563,G,DEL,707,1,1,0,0.14
barcode10,5,70942565,A,DEL,680,1,1,0,0.15
barcode10,5,70942566,T,DEL,678,1,1,0,0.15
barcode10,5,70942567,A,DEL,658,2,2,0,0.3
barcode10,5,70942569,A,DEL,644,110,110,0,17.08
barcode10,5,70942570,A,DEL,643,84,84,0,13.06
barcode10,5,70942571,A,DEL,641,45,45,0,7.02
barcode10,5,70942572,A,DEL,637,8,8,0,1.26
barcode10,5,70942587,T,DEL,211,1,1,0,0.47
barcode10,5,70942678,A,DEL,319,6,0,6,1.88
barcode10,5,70942682,T,DEL,393,1,0,1,0.25
barcode10,5,70942683,T,DEL,393,1,0,1,0.25
barcode10,5,70942686,A,DEL,410,3,0,3,0.73
barcode10,5,70942687,A,DEL,410,2,0,2,0.49
barcode10,5,70942688,C,DEL,410,2,0,2,0.49
barcode10,5,70942689,A,DEL,410,22,7,15,5.37
barcode10,5,70942692,A,DEL,415,1,0,1,0.24
barcode10,5,70942693,A,DEL,417,1,0,1,0.24
barcode10,5,70942694,C,DEL,418,1,0,1,0.24
barcode10,5,70942695,C,DEL,419,1,0,1,0.24
barcode10,5,70942696,T,DEL,419,1,0,1,0.24
barcode10,5,70942697,G,DEL,420,1,0,1,0.24
barcode10,5,70942698,C,DEL,420,1,0,1,0.24
barcode10,5,70942699,A,DEL,420,1,0,1,0.24
barcode10,5,70942700,T,DEL,420,3,0,3,0.71
barcode10,5,70942701,A,DEL,421,5,0,5,1.19
barcode10,5,70942702,T,DEL,421,19,3,16,4.51
barcode10,5,70942703,T,DEL,422,1,0,1,0.24
barcode10,5,70942704,T,DEL,426,1,0,1,0.23
barcode10,5,70942705,T,DEL,427,1,0,1,0.23
barcode10,5,70942706,T,DEL,428,5,0,5,1.17
barcode10,5,70942707,T,DEL,428,11,0,11,2.57
barcode10,5,70942708,C,DEL,429,23,0,23,5.36
barcode10,5,70942709,T,DEL,430,51,3,48,11.86
barcode10,5,70942710,T,DEL,431,4,1,3,0.93
barcode10,5,70942712,T,DEL,431,1,0,1,0.23
barcode10,5,70942713,T,DEL,433,5,0,5,1.15
barcode10,5,70942714,A,DEL,436,24,0,24,5.5
barcode10,5,70942718,A,DEL,438,9,0,9,2.05
barcode10,5,70942721,G,DEL,438,1,1,0,0.23
barcode10,5,70942722,A,DEL,441,54,8,46,12.24
barcode10,5,70942723,A,DEL,443,6,0,6,1.35
barcode10,5,70942726,T,DEL,445,1,0,1,0.22
barcode10,5,70942727,G,DEL,445,21,0,21,4.72
barcode10,5,70942734,A,DEL,456,13,0,13,2.85
barcode10,5,70942737,T,DEL,458,2,1,1,0.44
barcode10,5,70942740,C,DEL,467,1,0,1,0.21
barcode10,5,70942741,A,DEL,467,3,0,3,0.64
barcode10,5,70942745,G,DEL,468,1,0,1,0.21
barcode10,5,70942746,A,DEL,468,8,0,8,1.71
barcode10,5,70942749,A,DEL,469,34,0,34,7.25
barcode10,5,70942751,A,DEL,460,1,1,0,0.22
barcode10,5,70942752,G,DEL,461,1,1,0,0.22
barcode10,5,70942754,G,DEL,460,4,1,3,0.87
barcode10,5,70942755,A,DEL,458,5,1,4,1.09
barcode10,5,70942756,G,DEL,458,7,2,5,1.53
barcode10,5,70942757,A,DEL,461,14,0,14,3.04
barcode10,5,70942758,A,DEL,465,1,0,1,0.22
barcode10,5,70942759,C,DEL,466,1,0,1,0.21
barcode10,5,70942761,C,DEL,479,2,1,1,0.42
barcode10,5,70942762,C,DEL,482,1,1,0,0.21
barcode10,5,70942764,G,DEL,481,1,1,0,0.21
barcode10,5,70942766,T,DEL,478,23,1,22,4.81
barcode10,5,70942767,C,DEL,478,35,1,34,7.32
barcode10,5,70942768,T,DEL,481,2,1,1,0.42
barcode10,5,70942769,C,DEL,488,4,0,4,0.82
barcode10,5,70942770,C,DEL,499,1,0,1,0.2
barcode10,5,70942771,T,DEL,499,1,0,1,0.2
barcode10,5,70942772,G,DEL,500,6,0,6,1.2
barcode10,5,70942774,A,DEL,499,17,0,17,3.41
barcode10,5,70942780,A,DEL,498,1,0,1,0.2
barcode10,5,70942781,T,DEL,497,1,0,1,0.2
barcode10,5,70942783,A,DEL,495,1,0,1,0.2
barcode10,5,70942784,G,DEL,495,1,0,1,0.2
barcode10,5,70942785,A,DEL,391,2,0,2,0.51
barcode10,5,70942786,T,DEL,393,2,0,2,0.51
barcode10,5,70942787,A,DEL,373,3,0,3,0.8
barcode10,5,70942793,A,DEL,369,2,0,2,0.54
barcode10,5,70942796,C,DEL,369,7,5,2,1.9
barcode10,5,70942798,C,DEL,362,2,0,2,0.55
barcode10,5,70942799,A,DEL,339,2,0,2,0.59
barcode10,5,70942800,A,DEL,338,1,0,1,0.3
barcode10,5,70942801,A,DEL,337,3,0,3,0.89
barcode10,5,70942802,T,DEL,338,11,0,11,3.25
barcode10,5,70942803,C,DEL,341,4,0,4,1.17
barcode10,5,70942804,T,DEL,344,1,0,1,0.29
barcode10,5,70942808,C,DEL,379,4,1,3,1.06
barcode10,5,70942812,G,DEL,376,3,2,1,0.8
barcode10,5,70942816,C,DEL,365,1,0,1,0.27
barcode10,5,70942818,C,DEL,366,5,5,0,1.37
barcode10,5,70942819,T,DEL,367,25,3,22,6.81
barcode10,5,70942820,T,DEL,369,9,0,9,2.44
barcode10,5,70942821,T,DEL,368,7,0,7,1.9
barcode10,5,70942822,T,DEL,368,17,0,17,4.62
barcode10,5,70942823,C,DEL,367,27,1,26,7.36
barcode10,5,70942824,T,DEL,370,25,0,25,6.76
barcode10,5,70942825,C,DEL,372,62,7,55,16.67
barcode10,5,70942826,C,DEL,374,25,1,24,6.68
barcode10,5,70942827,C,DEL,380,12,1,11,3.16
barcode10,5,70942828,T,DEL,386,14,2,12,3.63
barcode10,5,70942829,C,DEL,385,24,5,19,6.23
barcode10,5,70942830,C,DEL,393,10,3,7,2.54
barcode10,5,70942831,A,DEL,395,4,3,1,1.01
barcode10,5,70942832,C,DEL,395,1,1,0,0.25
barcode10,5,70942833,C,DEL,397,2,0,2,0.5
barcode10,5,70942834,A,DEL,395,2,0,2,0.51
barcode10,5,70942835,C,DEL,395,108,84,24,27.34
barcode10,5,70942836,C,DEL,366,2,2,0,0.55
barcode10,5,70942837,C,DEL,368,1,1,0,0.27
barcode10,5,70942844,C,DEL,366,6,5,1,1.64
barcode10,5,70942845,C,DEL,366,1,0,1,0.27
barcode10,5,70942846,A,DEL,367,1,1,0,0.27
barcode10,5,70942847,G,DEL,367,4,3,1,1.09
barcode10,5,70942850,C,DEL,362,1,1,0,0.28
barcode10,5,70942852,A,DEL,362,29,9,20,8.01
barcode10,5,70942853,A,DEL,362,1,0,1,0.28
barcode10,5,70942854,G,DEL,363,1,0,1,0.28
barcode10,5,70942855,A,DEL,363,2,2,0,0.55
barcode10,5,70942857,T,DEL,362,11,0,11,3.04
barcode10,5,70942858,G,DEL,361,10,2,8,2.77
barcode10,5,70942861,A,DEL,362,1,0,1,0.28
barcode10,5,70942862,C,DEL,362,1,0,1,0.28
barcode10,5,70942863,C,DEL,364,1,0,1,0.27
barcode10,5,70942864,A,DEL,364,2,2,0,0.55
barcode10,5,70942865,G,DEL,364,1,0,1,0.27
barcode10,5,70942866,G,DEL,361,1,1,0,0.28
barcode10,5,70942867,A,DEL,359,30,5,25,8.36
barcode10,5,70942872,T,DEL,356,4,0,4,1.12
barcode10,5,70942873,A,DEL,353,1,0,1,0.28
barcode10,5,70942874,A,DEL,352,1,0,1,0.28
barcode10,5,70942875,A,DEL,352,1,0,1,0.28
barcode10,5,70942876,C,DEL,352,2,0,2,0.57
barcode10,5,70942877,C,DEL,353,1,0,1,0.28
barcode10,5,70942878,T,DEL,353,4,3,1,1.13
barcode10,5,70942881,T,DEL,354,2,0,2,0.56
barcode10,5,70942885,A,DEL,354,16,2,14,4.52
barcode10,5,70942886,A,DEL,354,1,0,1,0.28
barcode10,5,70942888,G,DEL,353,2,0,2,0.57
barcode10,5,70942889,T,DEL,353,8,3,5,2.27
barcode10,5,70942893,C,DEL,353,4,2,2,1.13
barcode10,5,70942894,C,DEL,353,3,1,2,0.85
barcode10,5,70942895,A,DEL,351,26,17,9,7.41
barcode10,5,70942896,G,DEL,351,31,21,10,8.83
barcode10,5,70942897,A,DEL,344,26,3,23,7.56
barcode10,5,70942898,A,DEL,342,2,2,0,0.58
barcode10,5,70942904,T,DEL,339,4,4,0,1.18
barcode10,5,70942906,A,DEL,337,33,0,33,9.79
barcode10,5,70942911,C,DEL,331,9,9,0,2.72
barcode10,5,70942912,G,DEL,331,4,1,3,1.21
barcode10,5,70942914,G,DEL,315,1,0,1,0.32
barcode10,5,70942915,A,DEL,306,1,0,1,0.33
barcode10,5,70942918,T,DEL,302,11,7,4,3.64
barcode10,5,70942920,T,DEL,299,2,0,2,0.67
barcode10,5,70942921,A,DEL,298,4,0,4,1.34
barcode10,5,70942926,C,DEL,289,1,1,0,0.35
barcode10,5,70942929,T,DEL,282,6,0,6,2.13
barcode10,5,70942931,T,DEL,279,9,9,0,3.23
barcode10,5,70942939,T,DEL,241,5,5,0,2.07
barcode10,5,70942947,T,DEL,160,5,0,5,3.12
barcode10,5,70942948,C,DEL,148,1,0,1,0.68
barcode10,5,70942949,T,DEL,144,1,0,1,0.69
barcode10,5,70944618,A,DEL,505,5,0,5,0.99
barcode10,5,70944621,T,DEL,539,1,0,1,0.19
barcode10,5,70944623,G,DEL,559,1,0,1,0.18
barcode10,5,70944624,G,DEL,566,1,0,1,0.18
barcode10,5,70944625,T,DEL,573,5,0,5,0.87
barcode10,5,70944626,A,DEL,581,23,0,23,3.96
barcode10,5,70944628,G,DEL,589,4,0,4,0.68
barcode10,5,70944629,T,DEL,592,2,1,1,0.34
barcode10,5,70944630,T,DEL,593,1,0,1,0.17
barcode10,5,70944631,A,DEL,601,2,0,2,0.33
barcode10,5,70944633,T,DEL,605,11,0,11,1.82
barcode10,5,70944639,T,DEL,632,15,7,8,2.37
barcode10,5,70944642,G,DEL,640,4,0,4,0.62
barcode10,5,70944643,A,DEL,642,4,0,4,0.62
barcode10,5,70944644,A,DEL,644,2,0,2,0.31
barcode10,5,70944646,T,DEL,645,1,0,1,0.16
barcode10,5,70944647,A,DEL,654,1,0,1,0.15
barcode10,5,70944648,T,DEL,654,9,4,5,1.38
barcode10,5,70944649,T,DEL,664,12,0,12,1.81
barcode10,5,70944650,C,DEL,664,12,0,12,1.81
barcode10,5,70944651,C,DEL,668,1,0,1,0.15
barcode10,5,70944652,T,DEL,670,14,0,14,2.09
barcode10,5,70944653,T,DEL,671,10,0,10,1.49
barcode10,5,70944661,G,DEL,728,1,1,0,0.14
barcode10,5,70944664,C,DEL,728,1,0,1,0.14
barcode10,5,70944665,T,DEL,729,9,0,9,1.23
barcode10,5,70944666,A,DEL,731,13,3,10,1.78
barcode10,5,70944667,A,DEL,732,3,0,3,0.41
barcode10,5,70944668,A,DEL,732,7,1,6,0.96
barcode10,5,70944669,A,DEL,732,7,1,6,0.96
barcode10,5,70944670,T,DEL,737,8,1,7,1.09
barcode10,5,70944671,T,DEL,739,2,1,1,0.27
barcode10,5,70944672,C,DEL,743,2,1,1,0.27
barcode10,5,70944673,A,DEL,749,4,0,4,0.53
barcode10,5,70944677,G,DEL,763,1,0,1,0.13
barcode10,5,70944678,C,DEL,768,20,0,20,2.6
barcode10,5,70944679,C,DEL,781,2,0,2,0.26
barcode10,5,70944680,C,DEL,782,3,1,2,0.38
barcode10,5,70944681,A,DEL,784,6,4,2,0.77
barcode10,5,70944682,C,DEL,788,1,1,0,0.13
barcode10,5,70944683,C,DEL,792,1,1,0,0.13
barcode10,5,70944684,A,DEL,795,1,1,0,0.13
barcode10,5,70944685,C,DEL,796,2,2,0,0.25
barcode10,5,70944686,C,DEL,795,2,2,0,0.25
barcode10,5,70944687,G,DEL,796,2,2,0,0.25
barcode10,5,70944691,C,DEL,799,2,1,1,0.25
barcode10,5,70944692,C,DEL,796,1,1,0,0.13
barcode10,5,70944693,G,DEL,801,3,1,2,0.37
barcode10,5,70944694,C,DEL,802,9,1,8,1.12
barcode10,5,70944695,C,DEL,804,9,1,8,1.12
barcode10,5,70944696,A,DEL,806,9,1,8,1.12
barcode10,5,70944697,C,DEL,812,3,2,1,0.37
barcode10,5,70944700,C,DEL,830,1,1,0,0.12
barcode10,5,70944701,C,DEL,828,1,1,0,0.12
barcode10,5,70944702,A,DEL,859,1,1,0,0.12
barcode10,5,70944703,C,DEL,860,2,2,0,0.23
barcode10,5,70944704,C,DEL,861,6,2,4,0.7
barcode10,5,70944705,A,DEL,867,7,2,5,0.81
barcode10,5,70944706,C,DEL,869,65,60,5,7.48
barcode10,5,70944707,C,DEL,882,4,0,4,0.45
barcode10,5,70944710,A,DEL,890,1,0,1,0.11
barcode10,5,70944712,T,DEL,878,3,3,0,0.34
barcode10,5,70944714,A,DEL,875,24,24,0,2.74
barcode10,5,70944715,C,DEL,869,1,1,0,0.12
barcode10,5,70944717,A,DEL,866,1,0,1,0.12
barcode10,5,70944718,T,DEL,868,1,0,1,0.12
barcode10,5,70944719,C,DEL,865,1,0,1,0.12
barcode10,5,70944723,C,DEL,851,7,1,6,0.82
barcode10,5,70944724,T,DEL,851,12,0,12,1.41
barcode10,5,70944725,G,DEL,852,1,0,1,0.12
barcode10,5,70944728,T,DEL,852,1,0,1,0.12
barcode10,5,70944729,G,DEL,852,7,5,2,0.82
barcode10,5,70944730,C,DEL,851,7,0,7,0.82
barcode10,5,70944733,C,DEL,851,4,0,4,0.47
barcode10,5,70944736,T,DEL,861,6,1,5,0.7
barcode10,5,70944739,C,DEL,856,2,0,2,0.23
barcode10,5,70944740,C,DEL,859,3,1,2,0.35
barcode10,5,70944741,T,DEL,859,30,11,19,3.49
barcode10,5,70944742,T,DEL,864,4,2,2,0.46
barcode10,5,70944743,C,DEL,861,5,1,4,0.58
barcode10,5,70944744,T,DEL,861,4,0,4,0.46
barcode10,5,70944745,G,DEL,858,2,0,2,0.23
barcode10,5,70944747,A,DEL,841,1,0,1,0.12
barcode10,5,70944748,C,DEL,833,2,1,1,0.24
barcode10,5,70944751,C,DEL,855,5,4,1,0.58
barcode10,5,70944753,A,DEL,852,4,0,4,0.47
barcode10,5,70944754,G,DEL,850,4,0,4,0.47
barcode10,5,70944755,T,DEL,850,12,0,12,1.41
barcode10,5,70944756,A,DEL,829,9,0,9,1.09
barcode10,5,70944757,A,DEL,828,8,0,8,0.97
barcode10,5,70944758,G,DEL,824,9,0,9,1.09
barcode10,5,70944759,T,DEL,823,33,0,33,4.01
barcode10,5,70944760,A,DEL,818,199,12,187,24.33
barcode10,5,70944761,A,DEL,816,95,2,93,11.64
barcode10,5,70944762,A,DEL,815,77,1,76,9.45
barcode10,5,70944763,A,DEL,815,18,0,18,2.21
barcode10,5,70944764,A,DEL,814,2,0,2,0.25
barcode10,5,70944765,A,DEL,812,1,0,1,0.12
barcode10,5,70944766,G,DEL,812,2,1,1,0.25
barcode10,5,70944767,A,DEL,811,1,1,0,0.12
barcode10,5,70944768,G,DEL,811,1,1,0,0.12
barcode10,5,70944769,T,DEL,809,49,0,49,6.06
barcode10,5,70944770,A,DEL,803,2,0,2,0.25
barcode10,5,70944771,T,DEL,803,4,1,3,0.5
barcode10,5,70944776,T,DEL,779,1,0,1,0.13
barcode10,5,70944777,A,DEL,778,6,0,6,0.77
barcode10,5,70944778,G,DEL,772,11,5,6,1.42
barcode10,5,70944779,A,DEL,764,1,0,1,0.13
barcode10,5,70944780,T,DEL,763,20,4,16,2.62
barcode10,5,70944785,C,DEL,749,3,0,3,0.4
barcode10,5,70944786,T,DEL,749,3,1,2,0.4
barcode10,5,70944790,A,DEL,734,3,0,3,0.41
barcode10,5,70944793,T,DEL,716,1,0,1,0.14
barcode10,5,70944798,T,DEL,684,4,3,1,0.58
barcode10,5,70944800,T,DEL,677,2,0,2,0.3
barcode10,5,70944801,G,DEL,674,2,0,2,0.3
barcode10,5,70944802,A,DEL,654,3,0,3,0.46
barcode10,5,70944803,T,DEL,653,1,0,1,0.15
barcode10,5,70944809,G,DEL,626,2,2,0,0.32
barcode10,5,70944813,A,DEL,595,3,3,0,0.5
barcode10,5,70944816,A,DEL,536,4,3,1,0.75
barcode10,5,70944817,G,DEL,528,4,2,2,0.76
barcode10,5,70944819,G,DEL,512,12,12,0,2.34
barcode10,5,70944820,G,DEL,485,1,1,0,0.21
barcode10,5,70944821,A,DEL,480,1,1,0,0.21
barcode10,5,70944822,T,DEL,479,3,2,1,0.63
barcode10,5,70944823,T,DEL,465,1,1,0,0.22
barcode10,5,70944825,T,DEL,457,1,0,1,0.22
barcode10,5,70944826,A,DEL,436,27,22,5,6.19
barcode10,5,70945984,C,DEL,1040,9,0,9,0.87
barcode10,5,70945985,C,DEL,1063,1,0,1,0.09
barcode10,5,70945986,A,DEL,1132,1,0,1,0.09
barcode10,5,70945987,G,DEL,1142,4,0,4,0.35
barcode10,5,70945988,C,DEL,1161,2,0,2,0.17
barcode10,5,70945990,T,DEL,1196,11,11,0,0.92
barcode10,5,70945994,C,DEL,1272,4,4,0,0.31
barcode10,5,70945995,T,DEL,1274,13,10,3,1.02
barcode10,5,70945996,A,DEL,1281,13,10,3,1.01
barcode10,5,70945998,A,DEL,1308,1,0,1,0.08
barcode10,5,70945999,T,DEL,1313,1,0,1,0.08
barcode10,5,70946000,A,DEL,1323,8,0,8,0.6
barcode10,5,70946001,A,DEL,1327,2,1,1,0.15
barcode10,5,70946002,T,DEL,1329,9,1,8,0.68
barcode10,5,70946003,A,DEL,1341,2,0,2,0.15
barcode10,5,70946004,T,DEL,1353,5,0,5,0.37
barcode10,5,70946005,A,DEL,1355,27,2,25,1.99
barcode10,5,70946006,A,DEL,1359,5,0,5,0.37
barcode10,5,70946009,C,DEL,1379,2,1,1,0.15
barcode10,5,70946010,T,DEL,1397,1,0,1,0.07
barcode10,5,70946011,C,DEL,1409,10,2,8,0.71
barcode10,5,70946012,C,DEL,1415,18,0,18,1.27
barcode10,5,70946013,A,DEL,1420,38,0,38,2.68
barcode10,5,70946014,G,DEL,1422,43,4,39,3.02
barcode10,5,70946015,A,DEL,1435,2,0,2,0.14
barcode10,5,70946016,C,DEL,1436,6,0,6,0.42
barcode10,5,70946017,T,DEL,1445,16,16,0,1.11
barcode10,5,70946019,T,DEL,1446,1,1,0,0.07
barcode10,5,70946020,A,DEL,1466,3,3,0,0.2
barcode10,5,70946022,T,DEL,1470,103,23,80,7.01
barcode10,5,70946023,T,DEL,1471,4,2,2,0.27
barcode10,5,70946024,T,DEL,1471,2,2,0,0.14
barcode10,5,70946025,T,DEL,1476,2,2,0,0.14
barcode10,5,70946026,T,DEL,1478,3,3,0,0.2
barcode10,5,70946027,T,DEL,1479,4,4,0,0.27
barcode10,5,70946028,G,DEL,1514,5,5,0,0.33
barcode10,5,70946029,T,DEL,1532,13,9,4,0.85
barcode10,5,70946032,A,DEL,1603,12,12,0,0.75
barcode10,5,70946033,C,DEL,1609,32,0,32,1.99
barcode10,5,70946034,T,DEL,1619,1,0,1,0.06
barcode10,5,70946035,G,DEL,1631,4,0,4,0.25
barcode10,5,70946036,G,DEL,1634,1,0,1,0.06
barcode10,5,70946037,A,DEL,1645,8,1,7,0.49
barcode10,5,70946038,T,DEL,1648,9,2,7,0.55
barcode10,5,70946039,A,DEL,1638,1,0,1,0.06
barcode10,5,70946040,T,DEL,1638,1,0,1,0.06
barcode10,5,70946041,A,DEL,1640,86,1,85,5.24
barcode10,5,70946042,A,DEL,1643,2,1,1,0.12
barcode10,5,70946043,A,DEL,1644,2,1,1,0.12
barcode10,5,70946044,C,DEL,1647,2,0,2,0.12
barcode10,5,70946045,A,DEL,1648,12,1,11,0.73
barcode10,5,70946046,A,DEL,1648,7,6,1,0.42
barcode10,5,70946047,T,DEL,1648,8,7,1,0.49
barcode10,5,70946048,A,DEL,1664,2,0,2,0.12
barcode10,5,70946049,T,DEL,1664,3,0,3,0.18
barcode10,5,70946050,C,DEL,1664,14,0,14,0.84
barcode10,5,70946051,T,DEL,1665,224,171,53,13.45
barcode10,5,70946052,T,DEL,1669,67,55,12,4.01
barcode10,5,70946053,T,DEL,1674,24,22,2,1.43
barcode10,5,70946054,T,DEL,1678,17,15,2,1.01
barcode10,5,70946055,T,DEL,1678,21,18,3,1.25
barcode10,5,70946056,C,DEL,1675,27,22,5,1.61
barcode10,5,70946057,T,DEL,1677,26,10,16,1.55
barcode10,5,70946058,G,DEL,1688,16,10,6,0.95
barcode10,5,70946059,T,DEL,1687,2,1,1,0.12
barcode10,5,70946060,C,DEL,1693,36,0,36,2.13
barcode10,5,70946062,C,DEL,1721,10,8,2,0.58
barcode10,5,70946063,C,DEL,1732,2,1,1,0.12
barcode10,5,70946064,A,DEL,1730,9,6,3,0.52
barcode10,5,70946065,G,DEL,1732,17,4,13,0.98
barcode10,5,70946066,A,DEL,1725,77,0,77,4.46
barcode10,5,70946067,T,DEL,1726,81,0,81,4.69
barcode10,5,70946068,A,DEL,1731,4,2,2,0.23
barcode10,5,70946069,A,DEL,1732,5,2,3,0.29
barcode10,5,70946070,T,DEL,1743,8,0,8,0.46
barcode10,5,70946071,T,DEL,1744,12,0,12,0.69
barcode10,5,70946072,C,DEL,1747,360,77,283,20.61
barcode10,5,70946073,C,DEL,1758,50,25,25,2.84
barcode10,5,70946074,C,DEL,1768,6,2,4,0.34
barcode10,5,70946075,C,DEL,1768,9,1,8,0.51
barcode10,5,70946076,C,DEL,1768,10,1,9,0.57
barcode10,5,70946077,A,DEL,1772,10,2,8,0.56
barcode10,5,70946078,C,DEL,1773,3,1,2,0.17
barcode10,5,70946079,C,DEL,1766,2,1,1,0.11
barcode10,5,70946080,A,DEL,1770,3,1,2,0.17
barcode10,5,70946081,C,DEL,1771,9,3,6,0.51
barcode10,5,70946082,C,DEL,1772,1,1,0,0.06
barcode10,5,70946083,T,DEL,1778,2,1,1,0.11
barcode10,5,70946084,C,DEL,1791,255,254,1,14.24
barcode10,5,70946086,C,DEL,1789,2,2,0,0.11
barcode10,5,70946087,A,DEL,1785,43,6,37,2.41
barcode10,5,70946088,T,DEL,1784,44,5,39,2.47
barcode10,5,70946090,T,DEL,1763,10,10,0,0.57
barcode10,5,70946091,G,DEL,1764,10,10,0,0.57
barcode10,5,70946092,T,DEL,1773,2,0,2,0.11
barcode10,5,70946093,C,DEL,1772,9,8,1,0.51
barcode10,5,70946094,C,DEL,1779,2,0,2,0.11
barcode10,5,70946095,A,DEL,1778,2,0,2,0.11
barcode10,5,70946096,G,DEL,1769,8,0,8,0.45
barcode10,5,70946097,A,DEL,1763,2,0,2,0.11
barcode10,5,70946098,T,DEL,1772,8,0,8,0.45
barcode10,5,70946099,T,DEL,1768,330,11,319,18.67
barcode10,5,70946100,C,DEL,1769,344,20,324,19.45
barcode10,5,70946101,T,DEL,1775,6,0,6,0.34
barcode10,5,70946102,C,DEL,1768,10,2,8,0.57
barcode10,5,70946103,T,DEL,1782,55,19,36,3.09
barcode10,5,70946104,T,DEL,1780,41,0,41,2.3
barcode10,5,70946105,G,DEL,1779,56,1,55,3.15
barcode10,5,70946106,A,DEL,1794,2,0,2,0.11
barcode10,5,70946107,T,DEL,1793,2,0,2,0.11
barcode10,5,70946108,G,DEL,1789,2,0,2,0.11
barcode10,5,70946109,A,DEL,1792,1,0,1,0.06
barcode10,5,70946110,T,DEL,1770,4,1,3,0.23
barcode10,5,70946111,G,DEL,1777,4,1,3,0.23
barcode10,5,70946112,C,DEL,1788,5,2,3,0.28
barcode10,5,70946114,G,DEL,1798,4,0,4,0.22
barcode10,5,70946115,A,DEL,1805,1,0,1,0.06
barcode10,5,70946117,G,DEL,1797,2,1,1,0.11
barcode10,5,70946118,C,DEL,1783,15,0,15,0.84
barcode10,5,70946119,T,DEL,1792,5,3,2,0.28
barcode10,5,70946120,T,DEL,1811,3,2,1,0.17
barcode10,5,70946121,T,DEL,1817,2,0,2,0.11
barcode10,5,70946122,G,DEL,1822,166,5,161,9.11
barcode10,5,70946123,G,DEL,1830,2,0,2,0.11
barcode10,5,70946124,G,DEL,1826,9,0,9,0.49
barcode10,5,70946125,A,DEL,1822,43,2,41,2.36
barcode10,5,70946126,A,DEL,1823,1,0,1,0.05
barcode10,5,70946127,G,DEL,1814,29,11,18,1.6
barcode10,5,70946128,T,DEL,1806,43,4,39,2.38
barcode10,5,70946129,A,DEL,1818,4,3,1,0.22
barcode10,5,70946130,T,DEL,1819,5,3,2,0.27
barcode10,5,70946131,G,DEL,1820,4,3,1,0.22
barcode10,5,70946132,T,DEL,1826,200,199,1,10.95
barcode10,5,70946133,T,DEL,1823,2,1,1,0.11
barcode10,5,70946134,A,DEL,1822,5,1,4,0.27
barcode10,5,70946135,A,DEL,1829,5,2,3,0.27
barcode10,5,70946136,T,DEL,1834,25,11,14,1.36
barcode10,5,70946138,T,DEL,1878,1,1,0,0.05
barcode10,5,70946139,C,DEL,1893,2,2,0,0.11
barcode10,5,70946140,A,DEL,1912,1,1,0,0.05
barcode10,5,70946141,T,DEL,1914,1,1,0,0.05
barcode10,5,70946142,G,DEL,1888,1,0,1,0.05
barcode10,5,70946143,G,DEL,1890,8,0,8,0.42
barcode10,5,70946144,T,DEL,1890,18,0,18,0.95
barcode10,5,70946145,A,DEL,1864,3,0,3,0.16
barcode10,5,70946146,C,DEL,1873,2,0,2,0.11
barcode10,5,70946148,T,DEL,1892,1,1,0,0.05
barcode10,5,70946149,G,DEL,1896,2,1,1,0.11
barcode10,5,70946150,A,DEL,1918,3,3,0,0.16
barcode10,5,70946151,G,DEL,1914,8,7,1,0.42
barcode10,5,70946152,T,DEL,1923,1,1,0,0.05
barcode10,5,70946154,G,DEL,1935,1,0,1,0.05
barcode10,5,70946155,C,DEL,1933,3,0,3,0.16
barcode10,5,70946156,T,DEL,1930,3,0,3,0.16
barcode10,5,70946157,A,DEL,1908,1,1,0,0.05
barcode10,5,70946160,A,DEL,1874,1,0,1,0.05
barcode10,5,70946161,T,DEL,1873,4,1,3,0.21
barcode10,5,70946162,A,DEL,1978,3,0,3,0.15
barcode10,5,70946163,C,DEL,1980,6,0,6,0.3
barcode10,5,70946164,T,DEL,1981,7,0,7,0.35
barcode10,5,70946168,T,DEL,1976,3,3,0,0.15
barcode10,5,70946169,A,DEL,1943,4,4,0,0.21
barcode10,5,70946170,T,DEL,1938,15,15,0,0.77
barcode10,5,70946171,T,DEL,1935,35,35,0,1.81
barcode10,5,70946172,A,DEL,1951,35,35,0,1.79
barcode10,5,70946173,T,DEL,1948,14,13,1,0.72
barcode10,5,70946174,A,DEL,1988,13,12,1,0.65
barcode10,5,70946175,T,DEL,1994,2,2,0,0.1
barcode10,5,70946176,G,DEL,1992,3,2,1,0.15
barcode10,5,70946177,G,DEL,2037,30,1,29,1.47
barcode10,5,70946178,T,DEL,2041,38,0,38,1.86
barcode10,5,70946179,A,DEL,2018,17,2,15,0.84
barcode10,5,70946180,A,DEL,2028,16,0,16,0.79
barcode10,5,70946181,G,DEL,2023,12,0,12,0.59
barcode10,5,70946182,T,DEL,2026,25,0,25,1.23
barcode10,5,70946183,A,DEL,1992,53,0,53,2.66
barcode10,5,70946186,C,DEL,2012,1,0,1,0.05
barcode10,5,70946188,C,DEL,2016,1,0,1,0.05
barcode10,5,70946189,T,DEL,2030,1,1,0,0.05
barcode10,5,70946190,C,DEL,2038,73,3,70,3.58
barcode10,5,70946191,A,DEL,2043,1,1,0,0.05
barcode10,5,70946192,G,DEL,2040,10,9,1,0.49
barcode10,5,70946193,C,DEL,2036,1,1,0,0.05
barcode10,5,70946194,A,DEL,2036,2,1,1,0.1
barcode10,5,70946195,T,DEL,2036,6,5,1,0.29
barcode10,5,70946196,C,DEL,2033,10,3,7,0.49
barcode10,5,70946197,T,DEL,2037,475,412,63,23.32
barcode10,5,70946198,T,DEL,2040,30,28,2,1.47
barcode10,5,70946199,T,DEL,2044,5,4,1,0.24
barcode10,5,70946200,T,DEL,2043,7,2,5,0.34
barcode10,5,70946201,C,DEL,2048,14,3,11,0.68
barcode10,5,70946202,C,DEL,2053,2,2,0,0.1
barcode10,5,70946203,T,DEL,2048,2,0,2,0.1
barcode10,5,70946204,G,DEL,2046,43,0,43,2.1
barcode10,5,70946207,A,DEL,2023,2,2,0,0.1
barcode10,5,70946208,A,DEL,2023,3,2,1,0.15
barcode10,5,70946209,T,DEL,2023,115,97,18,5.68
barcode10,5,70946210,T,DEL,2024,8,2,6,0.4
barcode10,5,70946211,T,DEL,2025,6,0,6,0.3
barcode10,5,70946212,T,DEL,2027,4,0,4,0.2
barcode10,5,70946215,T,DEL,2042,6,4,2,0.29
barcode10,5,70946216,G,DEL,2055,6,4,2,0.29
barcode10,5,70946217,T,DEL,2056,1,0,1,0.05
barcode10,5,70946220,T,DEL,2069,1,1,0,0.05
barcode10,5,70946221,T,DEL,2067,1,1,0,0.05
barcode10,5,70946222,A,DEL,2069,1,1,0,0.05
barcode10,5,70946225,T,DEL,2092,4,4,0,0.19
barcode10,5,70946228,C,DEL,2081,4,0,4,0.19
barcode10,5,70946229,T,DEL,2081,46,46,0,2.21
barcode10,5,70946230,T,DEL,2047,2,2,0,0.1
barcode10,5,70946231,T,DEL,2041,2,2,0,0.1
barcode10,5,70946232,G,DEL,2045,2,2,0,0.1
barcode10,5,70946233,T,DEL,2051,67,52,15,3.27
barcode10,5,70946234,T,DEL,2049,1,0,1,0.05
barcode10,5,70946235,T,DEL,2041,1,0,1,0.05
barcode10,5,70946236,T,DEL,2040,4,2,2,0.2
barcode10,5,70946237,G,DEL,2033,7,2,5,0.34
barcode10,5,70946239,A,DEL,2007,35,33,2,1.74
barcode10,5,70946240,A,DEL,2004,1,1,0,0.05
barcode10,5,70946241,A,DEL,2002,3,3,0,0.15
barcode10,5,70946242,T,DEL,2000,46,13,33,2.3
barcode10,5,70946243,T,DEL,1996,5,5,0,0.25
barcode10,5,70946244,T,DEL,1991,14,14,0,0.7
barcode10,5,70946245,A,DEL,1970,29,28,1,1.47
barcode10,5,70946246,T,DEL,1969,4,2,2,0.2
barcode10,5,70946247,A,DEL,1958,84,46,38,4.29
barcode10,5,70946248,A,DEL,1955,3,0,3,0.15
barcode10,5,70946251,T,DEL,1938,1,1,0,0.05
barcode10,5,70946252,A,DEL,1928,1,1,0,0.05
barcode10,5,70946253,C,DEL,1926,12,11,1,0.62
barcode10,5,70946254,T,DEL,1926,1,0,1,0.05
barcode10,5,70946255,A,DEL,1921,15,11,4,0.78
barcode10,5,70946256,C,DEL,1918,7,7,0,0.36
barcode10,5,70946257,T,DEL,1916,11,10,1,0.57
barcode10,5,70946260,C,DEL,1888,17,15,2,0.9
barcode10,5,70946261,T,DEL,1887,38,37,1,2.01
barcode10,5,70946262,T,DEL,1873,25,23,2,1.33
barcode10,5,70946263,C,DEL,1867,29,23,6,1.55
barcode10,5,70946264,T,DEL,1866,4,1,3,0.21
barcode10,5,70946265,C,DEL,1848,12,8,4,0.65
barcode10,5,70946266,T,DEL,1840,13,6,7,0.71
barcode10,5,70946267,C,DEL,1814,14,9,5,0.77
barcode10,5,70946268,T,DEL,1801,167,161,6,9.27
barcode10,5,70946269,T,DEL,1795,5,0,5,0.28
barcode10,5,70946270,T,DEL,1782,5,0,5,0.28
barcode10,5,70946271,A,DEL,1758,4,3,1,0.23
barcode10,5,70946272,T,DEL,1757,1,1,0,0.06
barcode10,5,70946273,A,DEL,1732,9,8,1,0.52
barcode10,5,70946274,T,DEL,1731,8,8,0,0.46
barcode10,5,70946275,T,DEL,1727,7,7,0,0.41
barcode10,5,70946276,A,DEL,1718,28,28,0,1.63
barcode10,5,70946277,C,DEL,1716,8,8,0,0.47
barcode10,5,70946279,A,DEL,1684,32,22,10,1.9
barcode10,5,70946280,A,DEL,1682,1,1,0,0.06
barcode10,5,70946281,A,DEL,1671,1,1,0,0.06
barcode10,5,70946285,T,DEL,1654,1,1,0,0.06
barcode10,5,70946286,A,DEL,1639,64,64,0,3.9
barcode10,5,70946287,A,DEL,1638,1,1,0,0.06
barcode10,5,70946291,T,DEL,1617,1,1,0,0.06
barcode10,5,70946292,A,DEL,1591,226,218,8,14.2
barcode10,5,70946293,A,DEL,1590,62,62,0,3.9
barcode10,5,70946294,A,DEL,1580,19,19,0,1.2
barcode10,5,70946295,A,DEL,1572,4,4,0,0.25
barcode10,5,70946299,T,DEL,1533,2,2,0,0.13
barcode10,5,70946301,C,DEL,1503,2,2,0,0.13
barcode10,5,70946302,A,DEL,1483,2,2,0,0.13
barcode10,5,70946305,T,DEL,1468,4,4,0,0.27
barcode10,5,70946306,G,DEL,1441,4,4,0,0.28
barcode10,5,70946307,T,DEL,1430,4,4,0,0.28
barcode10,5,70946308,C,DEL,1257,4,3,1,0.32
barcode10,5,70946309,T,DEL,1250,1,0,1,0.08
barcode10,5,70946310,G,DEL,1186,1,0,1,0.08
barcode10,5,70946315,T,DEL,973,5,5,0,0.51
barcode10,5,70946317,A,DEL,130,1,0,1,0.77
barcode10,5,70951929,T,DEL,5,1,1,0,20.0
barcode10,5,70951943,T,DEL,1256,16,0,16,1.27
barcode10,5,70951946,C,DEL,1291,7,0,7,0.54
barcode10,5,70951947,A,DEL,1293,8,0,8,0.62
barcode10,5,70951948,G,DEL,1294,17,1,16,1.31
barcode10,5,70951949,A,DEL,1304,7,0,7,0.54
barcode10,5,70951950,C,DEL,1307,7,0,7,0.54
barcode10,5,70951951,A,DEL,1309,235,1,234,17.95
barcode10,5,70951952,A,DEL,1315,2,0,2,0.15
barcode10,5,70951956,C,DEL,1325,4,0,4,0.3
barcode10,5,70951957,A,DEL,1326,191,17,174,14.4
barcode10,5,70951958,A,DEL,1331,21,3,18,1.58
barcode10,5,70951959,A,DEL,1336,1,0,1,0.07
barcode10,5,70951960,A,DEL,1339,1,1,0,0.07
barcode10,5,70951961,A,DEL,1342,1,1,0,0.07
barcode10,5,70951962,G,DEL,1343,4,3,1,0.3
barcode10,5,70951963,A,DEL,1350,106,1,105,7.85
barcode10,5,70951964,A,DEL,1353,3,3,0,0.22
barcode10,5,70951965,G,DEL,1356,4,4,0,0.29
barcode10,5,70951966,G,DEL,1362,2,2,0,0.15
barcode10,5,70951967,A,DEL,1371,109,1,108,7.95
barcode10,5,70951972,G,DEL,1394,1,0,1,0.07
barcode10,5,70951973,C,DEL,1402,20,0,20,1.43
barcode10,5,70951975,C,DEL,1421,14,0,14,0.99
barcode10,5,70951976,A,DEL,1422,16,0,16,1.13
barcode10,5,70951977,C,DEL,1440,1,0,1,0.07
barcode10,5,70951978,A,DEL,1444,3,0,3,0.21
barcode10,5,70951979,T,DEL,1452,3,3,0,0.21
barcode10,5,70951980,T,DEL,1455,3,0,3,0.21
barcode10,5,70951981,C,DEL,1460,7,0,7,0.48
barcode10,5,70951982,C,DEL,1467,4,0,4,0.27
barcode10,5,70951983,T,DEL,1469,26,4,22,1.77
barcode10,5,70951984,T,DEL,1473,18,1,17,1.22
barcode10,5,70951985,A,DEL,1479,30,17,13,2.03
barcode10,5,70951988,T,DEL,1495,1,0,1,0.07
barcode10,5,70951990,A,DEL,1504,35,0,35,2.33
barcode10,5,70951992,G,DEL,1517,4,4,0,0.26
barcode10,5,70951993,G,DEL,1522,2,2,0,0.13
barcode10,5,70951994,A,DEL,1533,7,5,2,0.46
barcode10,5,70951995,G,DEL,1531,15,5,10,0.98
barcode10,5,70951996,T,DEL,1541,9,1,8,0.58
barcode10,5,70951997,A,DEL,1548,8,3,5,0.52
barcode10,5,70951998,A,DEL,1556,2,0,2,0.13
barcode10,5,70952000,T,DEL,1568,3,2,1,0.19
barcode10,5,70952001,C,DEL,1573,17,3,14,1.08
barcode10,5,70952002,T,DEL,1592,13,0,13,0.82
barcode10,5,70952003,G,DEL,1661,7,0,7,0.42
barcode10,5,70952004,C,DEL,1712,27,18,9,1.58
barcode10,5,70952005,C,DEL,1714,9,0,9,0.53
barcode10,5,70952007,G,DEL,1733,6,0,6,0.35
barcode10,5,70952008,C,DEL,1715,1,0,1,0.06
barcode10,5,70952009,A,DEL,1704,1,0,1,0.06
barcode10,5,70952010,T,DEL,1705,6,5,1,0.35
barcode10,5,70952011,T,DEL,1707,6,5,1,0.35
barcode10,5,70952012,A,DEL,1721,9,5,4,0.52
barcode10,5,70952013,T,DEL,1721,3,0,3,0.17
barcode10,5,70952014,G,DEL,1722,4,0,4,0.23
barcode10,5,70952015,A,DEL,1735,275,31,244,15.85
barcode10,5,70952016,A,DEL,1741,1,0,1,0.06
barcode10,5,70952017,A,DEL,1733,1,0,1,0.06
barcode10,5,70952018,G,DEL,1732,1,0,1,0.06
barcode10,5,70952019,T,DEL,1740,1,0,1,0.06
barcode10,5,70952020,G,DEL,1737,4,0,4,0.23
barcode10,5,70952021,A,DEL,1740,1,0,1,0.06
barcode10,5,70952023,T,DEL,1743,9,4,5,0.52
barcode10,5,70952024,C,DEL,1749,5,3,2,0.29
barcode10,5,70952025,T,DEL,1750,15,9,6,0.86
barcode10,5,70952026,T,DEL,1751,4,0,4,0.23
barcode10,5,70952027,A,DEL,1771,1,0,1,0.06
barcode10,5,70952028,C,DEL,1773,1,0,1,0.06
barcode10,5,70952029,T,DEL,1783,143,11,132,8.02
barcode10,5,70952030,T,DEL,1780,1,1,0,0.06
barcode10,5,70952031,T,DEL,1780,4,4,0,0.22
barcode10,5,70952032,T,DEL,1781,7,7,0,0.39
barcode10,5,70952033,G,DEL,1783,13,11,2,0.73
barcode10,5,70952034,T,DEL,1777,55,2,53,3.1
barcode10,5,70952035,A,DEL,1776,15,5,10,0.84
barcode10,5,70952036,A,DEL,1779,3,0,3,0.17
barcode10,5,70952040,T,DEL,1779,4,3,1,0.22
barcode10,5,70952047,T,DEL,1796,12,1,11,0.67
barcode10,5,70952049,T,DEL,1800,1,0,1,0.06
barcode10,5,70952050,G,DEL,1852,2,1,1,0.11
barcode10,5,70952052,G,DEL,1859,12,8,4,0.65
barcode10,5,70952054,A,DEL,1855,12,0,12,0.65
barcode10,5,70952055,A,DEL,1823,1,0,1,0.05
barcode10,5,70952056,A,DEL,1823,1,0,1,0.05
barcode10,5,70952057,A,DEL,1819,1,0,1,0.05
barcode10,5,70952058,C,DEL,1821,4,0,4,0.22
barcode10,5,70952059,A,DEL,1818,110,1,109,6.05
barcode10,5,70952060,A,DEL,1817,1,0,1,0.06
barcode10,5,70952061,A,DEL,1816,2,0,2,0.11
barcode10,5,70952062,T,DEL,1813,4,2,2,0.22
barcode10,5,70952063,G,DEL,1811,4,3,1,0.22
barcode10,5,70952064,T,DEL,1812,93,22,71,5.13
barcode10,5,70952065,T,DEL,1810,6,1,5,0.33
barcode10,5,70952069,G,DEL,1816,6,1,5,0.33
barcode10,5,70952070,A,DEL,1847,11,0,11,0.6
barcode10,5,70952071,A,DEL,1843,3,3,0,0.16
barcode10,5,70952072,C,DEL,1836,7,7,0,0.38
barcode10,5,70952074,T,DEL,1836,13,5,8,0.71
barcode10,5,70952075,T,DEL,1836,2,1,1,0.11
barcode10,5,70952076,T,DEL,1828,4,0,4,0.22
barcode10,5,70952077,A,DEL,1840,160,2,158,8.7
barcode10,5,70952078,A,DEL,1852,33,0,33,1.78
barcode10,5,70952079,A,DEL,1853,1,0,1,0.05
barcode10,5,70952080,A,DEL,1847,1,0,1,0.05
barcode10,5,70952081,A,DEL,1839,3,0,3,0.16
barcode10,5,70952082,G,DEL,1838,6,0,6,0.33
barcode10,5,70952083,T,DEL,1844,31,31,0,1.68
barcode10,5,70952084,T,DEL,1839,7,7,0,0.38
barcode10,5,70952085,C,DEL,1837,29,23,6,1.58
barcode10,5,70952086,A,DEL,1829,63,1,62,3.44
barcode10,5,70952087,G,DEL,1826,71,1,70,3.89
barcode10,5,70952088,A,DEL,1814,3,1,2,0.17
barcode10,5,70952089,T,DEL,1812,2,0,2,0.11
barcode10,5,70952090,G,DEL,1840,1,0,1,0.05
barcode10,5,70952091,T,DEL,1839,18,17,1,0.98
barcode10,5,70952092,T,DEL,1886,1,0,1,0.05
barcode10,5,70952093,A,DEL,1902,85,2,83,4.47
barcode10,5,70952094,A,DEL,1865,9,0,9,0.48
barcode10,5,70952095,A,DEL,1882,1,0,1,0.05
barcode10,5,70952096,A,DEL,1886,1,0,1,0.05
barcode10,5,70952097,A,DEL,1877,1,0,1,0.05
barcode10,5,70952098,G,DEL,1861,6,2,4,0.32
barcode10,5,70952099,T,DEL,1870,14,10,4,0.75
barcode10,5,70952100,T,DEL,1870,1,0,1,0.05
barcode10,5,70952101,G,DEL,1878,9,0,9,0.48
barcode10,5,70952102,A,DEL,1933,130,0,130,6.73
barcode10,5,70952103,A,DEL,1938,1,0,1,0.05
barcode10,5,70952105,G,DEL,1923,2,0,2,0.1
barcode10,5,70952107,T,DEL,1941,10,10,0,0.52
barcode10,5,70952109,A,DEL,1937,5,0,5,0.26
barcode10,5,70952111,T,DEL,1926,2,0,2,0.1
barcode10,5,70952112,G,DEL,1928,1,0,1,0.05
barcode10,5,70952113,T,DEL,1924,42,2,40,2.18
barcode10,5,70952114,A,DEL,1927,18,3,15,0.93
barcode10,5,70952115,A,DEL,1927,2,0,2,0.1
barcode10,5,70952116,A,DEL,1956,1,0,1,0.05
barcode10,5,70952118,C,DEL,1946,2,0,2,0.1
barcode10,5,70952123,A,DEL,1835,3,0,3,0.16
barcode10,5,70952124,A,DEL,1831,1,0,1,0.05
barcode10,5,70952125,T,DEL,1829,3,0,3,0.16
barcode10,5,70952126,A,DEL,1797,2,2,0,0.11
barcode10,5,70952127,T,DEL,1796,24,24,0,1.34
barcode10,5,70952129,A,DEL,1791,17,0,17,0.95
barcode10,5,70952130,A,DEL,1791,1,0,1,0.06
barcode10,5,70952132,G,DEL,1778,2,2,0,0.11
barcode10,5,70952133,A,DEL,1763,2,2,0,0.11
barcode10,5,70952134,A,DEL,1761,4,2,2,0.23
barcode10,5,70952135,T,DEL,1744,215,117,98,12.33
barcode10,5,70952139,G,DEL,1736,2,0,2,0.12
barcode10,5,70952140,A,DEL,1735,1,1,0,0.06
barcode10,5,70952142,G,DEL,1729,1,1,0,0.06
barcode10,5,70952143,C,DEL,1732,35,31,4,2.02
barcode10,5,70952144,C,DEL,1725,2,0,2,0.12
barcode10,5,70952145,A,DEL,1704,17,10,7,1.0
barcode10,5,70952150,T,DEL,1678,3,0,3,0.18
barcode10,5,70952152,T,DEL,1674,9,9,0,0.54
barcode10,5,70952153,T,DEL,1674,1,0,1,0.06
barcode10,5,70952154,A,DEL,1644,4,1,3,0.24
barcode10,5,70952155,G,DEL,1642,11,7,4,0.67
barcode10,5,70952157,T,DEL,1636,1,1,0,0.06
barcode10,5,70952158,A,DEL,1623,37,24,13,2.28
barcode10,5,70952164,T,DEL,1602,9,9,0,0.56
barcode10,5,70952165,T,DEL,1589,3,3,0,0.19
barcode10,5,70952166,A,DEL,1573,1,0,1,0.06
barcode10,5,70952168,T,DEL,1564,1,0,1,0.06
barcode10,5,70952169,C,DEL,1539,4,0,4,0.26
barcode10,5,70952170,T,DEL,1530,11,0,11,0.72
barcode10,5,70952173,A,DEL,1448,3,0,3,0.21
barcode10,5,70952174,T,DEL,1446,7,1,6,0.48
barcode10,5,70952175,C,DEL,1432,19,15,4,1.33
barcode10,5,70952177,C,DEL,1425,1,0,1,0.07
barcode10,5,70952178,T,DEL,1394,7,0,7,0.5
barcode10,5,70952179,A,DEL,1355,17,17,0,1.25
barcode10,5,70952180,C,DEL,1337,1,1,0,0.07
barcode10,5,70952182,A,DEL,1271,6,6,0,0.47
barcode10,5,70952183,G,DEL,1264,5,5,0,0.4
barcode10,5,70952184,A,DEL,1260,3,1,2,0.24
barcode10,5,70952187,T,DEL,1240,1,1,0,0.08
barcode10,5,70952188,C,DEL,1226,2,2,0,0.16
barcode10,5,70952189,T,DEL,1197,3,0,3,0.25
barcode10,5,70952190,C,DEL,1180,1,0,1,0.08
barcode10,5,70952191,A,DEL,1170,1,0,1,0.09
barcode10,5,70952192,T,DEL,1160,1,0,1,0.09
barcode10,5,70952193,A,DEL,1132,5,4,1,0.44
barcode10,5,70952194,C,DEL,1029,5,4,1,0.49
barcode10,5,70952195,T,DEL,1010,7,7,0,0.69
barcode10,5,70952203,T,DEL,825,4,4,0,0.48
barcode13,5,70924860,A,DEL,484,24,0,24,4.96
barcode13,5,70924864,C,DEL,822,2,0,2,0.24
barcode13,5,70924865,A,DEL,888,8,0,8,0.9
barcode13,5,70924867,A,DEL,918,1,0,1,0.11
barcode13,5,70924868,C,DEL,936,11,1,10,1.18
barcode13,5,70924869,A,DEL,963,14,0,14,1.45
barcode13,5,70924870,A,DEL,963,3,1,2,0.31
barcode13,5,70924871,A,DEL,969,11,1,10,1.14
barcode13,5,70924872,C,DEL,970,32,1,31,3.3
barcode13,5,70924873,A,DEL,972,303,27,276,31.17
barcode13,5,70924874,A,DEL,973,135,11,124,13.87
barcode13,5,70924875,A,DEL,978,45,0,45,4.6
barcode13,5,70924876,A,DEL,980,13,0,13,1.33
barcode13,5,70924877,A,DEL,983,8,0,8,0.81
barcode13,5,70924878,A,DEL,989,2,0,2,0.2
barcode13,5,70924883,G,DEL,1011,1,0,1,0.1
barcode13,5,70924884,G,DEL,1017,1,0,1,0.1
barcode13,5,70924885,A,DEL,1027,43,0,43,4.19
barcode13,5,70924890,A,DEL,1055,8,1,7,0.76
barcode13,5,70924891,A,DEL,1057,3,0,3,0.28
barcode13,5,70924894,A,DEL,1081,2,0,2,0.19
barcode13,5,70924895,T,DEL,1081,5,0,5,0.46
barcode13,5,70924896,A,DEL,1091,12,0,12,1.1
barcode13,5,70924901,A,DEL,1270,3,0,3,0.24
barcode13,5,70924902,G,DEL,1285,3,0,3,0.23
barcode13,5,70924903,T,DEL,1287,3,0,3,0.23
barcode13,5,70924904,G,DEL,1295,2,1,1,0.15
barcode13,5,70924905,A,DEL,1301,31,0,31,2.38
barcode13,5,70924908,T,DEL,1322,1,0,1,0.08
barcode13,5,70924909,G,DEL,1328,1,0,1,0.08
barcode13,5,70924910,A,DEL,1354,26,1,25,1.92
barcode13,5,70924911,A,DEL,1361,1,0,1,0.07
barcode13,5,70924912,A,DEL,1363,1,0,1,0.07
barcode13,5,70924913,G,DEL,1367,3,1,2,0.22
barcode13,5,70924915,A,DEL,1400,2,1,1,0.14
barcode13,5,70924916,T,DEL,1402,8,8,0,0.57
barcode13,5,70924917,T,DEL,1405,1,1,0,0.07
barcode13,5,70924918,G,DEL,1412,8,5,3,0.57
barcode13,5,70924919,A,DEL,1457,7,3,4,0.48
barcode13,5,70924920,G,DEL,1466,3,2,1,0.2
barcode13,5,70924921,A,DEL,1479,4,1,3,0.27
barcode13,5,70924922,G,DEL,1484,11,0,11,0.74
barcode13,5,70924923,A,DEL,1489,6,1,5,0.4
barcode13,5,70924927,G,DEL,1500,5,0,5,0.33
barcode13,5,70924928,A,DEL,1509,116,18,98,7.69
barcode13,5,70924929,A,DEL,1517,4,2,2,0.26
barcode13,5,70924930,A,DEL,1519,2,0,2,0.13
barcode13,5,70924931,A,DEL,1522,7,5,2,0.46
barcode13,5,70924932,A,DEL,1524,8,6,2,0.52
barcode13,5,70924933,T,DEL,1528,11,6,5,0.72
barcode13,5,70924934,A,DEL,1552,1,1,0,0.06
barcode13,5,70924936,A,DEL,1582,3,2,1,0.19
barcode13,5,70924937,C,DEL,1593,3,2,1,0.19
barcode13,5,70924938,A,DEL,1596,1,0,1,0.06
barcode13,5,70924939,C,DEL,1602,3,1,2,0.19
barcode13,5,70924940,G,DEL,1617,2,1,1,0.12
barcode13,5,70924941,C,DEL,1626,4,2,2,0.25
barcode13,5,70924942,C,DEL,1632,4,1,3,0.25
barcode13,5,70924943,A,DEL,1635,3,1,2,0.18
barcode13,5,70924945,A,DEL,1627,56,12,44,3.44
barcode13,5,70924946,A,DEL,1637,2,0,2,0.12
barcode13,5,70924947,A,DEL,1639,2,0,2,0.12
barcode13,5,70924948,T,DEL,1638,5,1,4,0.31
barcode13,5,70924949,G,DEL,1652,6,1,5,0.36
barcode13,5,70924950,T,DEL,1657,10,4,6,0.6
barcode13,5,70924951,G,DEL,1667,358,28,330,21.48
barcode13,5,70924952,G,DEL,1688,1,0,1,0.06
barcode13,5,70924953,G,DEL,1693,1,0,1,0.06
barcode13,5,70924954,A,DEL,1704,1,0,1,0.06
barcode13,5,70924955,G,DEL,1703,10,3,7,0.59
barcode13,5,70924959,G,DEL,1712,2,0,2,0.12
barcode13,5,70924962,A,DEL,1727,13,0,13,0.75
barcode13,5,70924964,C,DEL,1727,1,1,0,0.06
barcode13,5,70924967,C,DEL,1732,12,0,12,0.69
barcode13,5,70924968,T,DEL,1735,45,0,45,2.59
barcode13,5,70924969,C,DEL,1734,28,0,28,1.61
barcode13,5,70924970,G,DEL,1733,13,0,13,0.75
barcode13,5,70924971,T,DEL,1733,44,0,44,2.54
barcode13,5,70924972,A,DEL,1736,17,7,10,0.98
barcode13,5,70924973,G,DEL,1741,17,2,15,0.98
barcode13,5,70924974,A,DEL,1758,12,2,10,0.68
barcode13,5,70924978,C,DEL,1781,1,1,0,0.06
barcode13,5,70924979,G,DEL,1777,1,0,1,0.06
barcode13,5,70924980,T,DEL,1773,1,1,0,0.06
barcode13,5,70924981,G,DEL,1777,26,21,5,1.46
barcode13,5,70924982,A,DEL,1789,4,2,2,0.22
barcode13,5,70924983,G,DEL,1788,17,10,7,0.95
barcode13,5,70924984,A,DEL,1787,8,4,4,0.45
barcode13,5,70924987,T,DEL,1794,3,3,0,0.17
barcode13,5,70924988,T,DEL,1796,9,9,0,0.5
barcode13,5,70924989,A,DEL,1798,12,12,0,0.67
barcode13,5,70924990,C,DEL,1795,12,11,1,0.67
barcode13,5,70924991,T,DEL,1799,5,2,3,0.28
barcode13,5,70924992,A,DEL,1811,4,4,0,0.22
barcode13,5,70924993,C,DEL,1815,4,2,2,0.22
barcode13,5,70924994,A,DEL,1821,7,3,4,0.38
barcode13,5,70924996,G,DEL,1840,1,1,0,0.05
barcode13,5,70924997,C,DEL,1848,1,1,0,0.05
barcode13,5,70925000,T,DEL,1848,109,0,109,5.9
barcode13,5,70925001,C,DEL,1844,117,0,117,6.34
barcode13,5,70925002,C,DEL,1846,12,0,12,0.65
barcode13,5,70925003,T,DEL,1863,15,1,14,0.81
barcode13,5,70925004,C,DEL,1880,172,133,39,9.15
barcode13,5,70925007,G,DEL,1904,3,2,1,0.16
barcode13,5,70925010,C,DEL,1903,1,1,0,0.05
barcode13,5,70925011,A,DEL,1909,3,3,0,0.16
barcode13,5,70925012,C,DEL,1910,1,1,0,0.05
barcode13,5,70925014,G,DEL,1911,6,0,6,0.31
barcode13,5,70925015,T,DEL,1909,1,0,1,0.05
barcode13,5,70925016,A,DEL,1908,1,0,1,0.05
barcode13,5,70925017,C,DEL,1910,6,5,1,0.31
barcode13,5,70925018,T,DEL,1910,1,0,1,0.05
barcode13,5,70925019,G,DEL,1910,2,1,1,0.1
barcode13,5,70925020,T,DEL,1911,133,9,124,6.96
barcode13,5,70925021,T,DEL,1921,1,1,0,0.05
barcode13,5,70925022,C,DEL,1933,13,3,10,0.67
barcode13,5,70925023,C,DEL,1934,2,2,0,0.1
barcode13,5,70925024,G,DEL,1935,2,2,0,0.1
barcode13,5,70925025,C,DEL,1934,2,0,2,0.1
barcode13,5,70925026,T,DEL,1941,2,2,0,0.1
barcode13,5,70925027,C,DEL,1949,248,233,15,12.72
barcode13,5,70925029,C,DEL,1961,3,2,1,0.15
barcode13,5,70925030,A,DEL,1962,8,3,5,0.41
barcode13,5,70925031,G,DEL,1966,5,0,5,0.25
barcode13,5,70925032,A,DEL,1966,8,1,7,0.41
barcode13,5,70925033,A,DEL,1968,1,0,1,0.05
barcode13,5,70925034,G,DEL,1967,2,0,2,0.1
barcode13,5,70925035,C,DEL,1968,255,182,73,12.96
barcode13,5,70925036,C,DEL,1972,2,0,2,0.1
barcode13,5,70925037,C,DEL,1972,1,1,0,0.05
barcode13,5,70925038,C,DEL,1972,24,22,2,1.22
barcode13,5,70925039,G,DEL,1973,95,64,31,4.82
barcode13,5,70925040,G,DEL,1977,2,1,1,0.1
barcode13,5,70925041,G,DEL,1965,1,1,0,0.05
barcode13,5,70925042,C,DEL,1961,1,1,0,0.05
barcode13,5,70925043,G,DEL,1961,1,1,0,0.05
barcode13,5,70925044,G,DEL,1972,1,0,1,0.05
barcode13,5,70925045,C,DEL,1972,1,0,1,0.05
barcode13,5,70925046,G,DEL,1972,15,8,7,0.76
barcode13,5,70925047,G,DEL,1972,4,1,3,0.2
barcode13,5,70925048,A,DEL,1968,173,5,168,8.79
barcode13,5,70925052,C,DEL,1952,1,1,0,0.05
barcode13,5,70925054,T,DEL,1961,1,0,1,0.05
barcode13,5,70925055,C,DEL,1957,3,0,3,0.15
barcode13,5,70925056,A,DEL,1955,1,1,0,0.05
barcode13,5,70925057,C,DEL,1953,2,1,1,0.1
barcode13,5,70925058,T,DEL,1952,8,2,6,0.41
barcode13,5,70925059,C,DEL,1945,8,2,6,0.41
barcode13,5,70925060,T,DEL,1947,70,31,39,3.6
barcode13,5,70925061,T,DEL,1933,19,1,18,0.98
barcode13,5,70925062,A,DEL,1910,42,7,35,2.2
barcode13,5,70925063,A,DEL,1905,5,2,3,0.26
barcode13,5,70925064,G,DEL,1901,3,0,3,0.16
barcode13,5,70925065,A,DEL,1904,57,27,30,2.99
barcode13,5,70925066,A,DEL,1898,16,15,1,0.84
barcode13,5,70925067,G,DEL,1894,58,40,18,3.06
barcode13,5,70925068,G,DEL,1879,7,7,0,0.37
barcode13,5,70925069,G,DEL,1870,1,1,0,0.05
barcode13,5,70925070,A,DEL,1860,2,2,0,0.11
barcode13,5,70925071,C,DEL,1827,4,4,0,0.22
barcode13,5,70925072,G,DEL,1818,69,51,18,3.8
barcode13,5,70925073,G,DEL,1765,7,6,1,0.4
barcode13,5,70925074,G,DEL,1737,9,9,0,0.52
barcode13,5,70925075,G,DEL,1715,88,84,4,5.13
barcode13,5,70925076,C,DEL,1715,155,138,17,9.04
barcode13,5,70925077,C,DEL,1769,76,66,10,4.3
barcode13,5,70925078,C,DEL,1769,62,59,3,3.5
barcode13,5,70925079,C,DEL,1792,27,24,3,1.51
barcode13,5,70925080,A,DEL,1782,46,44,2,2.58
barcode13,5,70925081,C,DEL,1776,7,6,1,0.39
barcode13,5,70925082,G,DEL,1911,15,15,0,0.78
barcode13,5,70925083,C,DEL,1918,1,1,0,0.05
barcode13,5,70925084,T,DEL,1916,5,3,2,0.26
barcode13,5,70925085,G,DEL,1900,13,13,0,0.68
barcode13,5,70925086,C,DEL,1845,8,8,0,0.43
barcode13,5,70925088,C,DEL,1858,12,2,10,0.65
barcode13,5,70925089,A,DEL,1847,7,4,3,0.38
barcode13,5,70925090,C,DEL,1844,19,16,3,1.03
barcode13,5,70925091,C,DEL,1845,1,1,0,0.05
barcode13,5,70925092,C,DEL,1841,9,9,0,0.49
barcode13,5,70925093,G,DEL,1854,12,11,1,0.65
barcode13,5,70925094,C,DEL,1861,2,0,2,0.11
barcode13,5,70925095,G,DEL,1860,16,3,13,0.86
barcode13,5,70925096,G,DEL,1864,1,1,0,0.05
barcode13,5,70925097,G,DEL,1853,3,3,0,0.16
barcode13,5,70925098,T,DEL,1863,11,11,0,0.59
barcode13,5,70925099,T,DEL,1863,2,1,1,0.11
barcode13,5,70925100,T,DEL,1859,5,4,1,0.27
barcode13,5,70925101,G,DEL,1863,5,4,1,0.27
barcode13,5,70925102,C,DEL,1862,6,4,2,0.32
barcode13,5,70925103,T,DEL,1861,6,2,4,0.32
barcode13,5,70925104,A,DEL,1865,3,2,1,0.16
barcode13,5,70925108,C,DEL,1852,3,0,3,0.16
barcode13,5,70925109,G,DEL,1847,17,0,17,0.92
barcode13,5,70925110,A,DEL,1848,17,0,17,0.92
barcode13,5,70925112,G,DEL,1839,7,2,5,0.38
barcode13,5,70925113,A,DEL,1837,9,3,6,0.49
barcode13,5,70925114,G,DEL,1836,28,2,26,1.53
barcode13,5,70925115,C,DEL,1837,26,1,25,1.42
barcode13,5,70925116,A,DEL,1839,2,1,1,0.11
barcode13,5,70925117,G,DEL,1841,6,3,3,0.33
barcode13,5,70925118,C,DEL,1839,7,4,3,0.38
barcode13,5,70925119,G,DEL,1834,4,2,2,0.22
barcode13,5,70925122,G,DEL,1804,1,0,1,0.06
barcode13,5,70925124,C,DEL,1765,2,0,2,0.11
barcode13,5,70925125,A,DEL,1755,13,12,1,0.74
barcode13,5,70925126,G,DEL,1754,11,11,0,0.63
barcode13,5,70925127,T,DEL,1754,12,12,0,0.68
barcode13,5,70925128,G,DEL,1749,2,2,0,0.11
barcode13,5,70925129,G,DEL,1736,3,2,1,0.17
barcode13,5,70925130,T,DEL,1736,3,2,1,0.17
barcode13,5,70925131,G,DEL,1732,11,10,1,0.64
barcode13,5,70925132,G,DEL,1732,11,10,1,0.64
barcode13,5,70925133,C,DEL,1726,11,10,1,0.64
barcode13,5,70925134,G,DEL,1724,14,4,10,0.81
barcode13,5,70925136,C,DEL,1703,2,2,0,0.12
barcode13,5,70925137,G,DEL,1699,2,1,1,0.12
barcode13,5,70925138,T,DEL,1696,2,2,0,0.12
barcode13,5,70925139,C,DEL,1692,71,68,3,4.2
barcode13,5,70925141,C,DEL,1694,4,4,0,0.24
barcode13,5,70925142,G,DEL,1692,22,19,3,1.3
barcode13,5,70925143,G,DEL,1688,6,5,1,0.36
barcode13,5,70925144,A,DEL,1667,12,12,0,0.72
barcode13,5,70925145,G,DEL,1657,34,17,17,2.05
barcode13,5,70925146,C,DEL,1655,14,13,1,0.85
barcode13,5,70925147,A,DEL,1644,35,35,0,2.13
barcode13,5,70925148,G,DEL,1644,35,35,0,2.13
barcode13,5,70925149,G,DEL,1640,28,28,0,1.71
barcode13,5,70925150,A,DEL,1631,13,13,0,0.8
barcode13,5,70925151,G,DEL,1626,41,41,0,2.52
barcode13,5,70925152,G,DEL,1623,54,54,0,3.33
barcode13,5,70925153,A,DEL,1618,54,54,0,3.34
barcode13,5,70925154,T,DEL,1619,80,75,5,4.94
barcode13,5,70925155,T,DEL,1605,2,0,2,0.12
barcode13,5,70925156,C,DEL,1605,4,1,3,0.25
barcode13,5,70925158,G,DEL,1599,6,0,6,0.38
barcode13,5,70925159,T,DEL,1594,4,0,4,0.25
barcode13,5,70925161,C,DEL,1544,1,1,0,0.06
barcode13,5,70925162,T,DEL,1543,4,1,3,0.26
barcode13,5,70925163,G,DEL,1541,2,1,1,0.13
barcode13,5,70925164,T,DEL,1533,30,28,2,1.96
barcode13,5,70925165,T,DEL,1526,4,3,1,0.26
barcode13,5,70925166,C,DEL,1519,8,5,3,0.53
barcode13,5,70925167,C,DEL,1511,6,4,2,0.4
barcode13,5,70925168,G,DEL,1507,32,10,22,2.12
barcode13,5,70925169,G,DEL,1494,7,7,0,0.47
barcode13,5,70925170,C,DEL,1473,4,4,0,0.27
barcode13,5,70925171,G,DEL,1454,5,5,0,0.34
barcode13,5,70925172,C,DEL,1447,2,1,1,0.14
barcode13,5,70925173,G,DEL,1432,1,1,0,0.07
barcode13,5,70925175,C,DEL,1427,1,1,0,0.07
barcode13,5,70925176,A,DEL,1411,1,1,0,0.07
barcode13,5,70925178,A,DEL,1406,7,7,0,0.5
barcode13,5,70925180,G,DEL,1401,1,1,0,0.07
barcode13,5,70925181,C,DEL,1397,9,9,0,0.64
barcode13,5,70925182,C,DEL,1391,1,1,0,0.07
barcode13,5,70925183,A,DEL,1391,2,2,0,0.14
barcode13,5,70925187,G,DEL,1369,3,3,0,0.22
barcode13,5,70925188,A,DEL,1361,3,3,0,0.22
barcode13,5,70925191,T,DEL,1338,1,1,0,0.07
barcode13,5,70925192,C,DEL,1319,5,4,1,0.38
barcode13,5,70925193,G,DEL,1314,6,4,2,0.46
barcode13,5,70925194,C,DEL,1302,10,0,10,0.77
barcode13,5,70925196,G,DEL,1284,1,1,0,0.08
barcode13,5,70925197,C,DEL,1276,12,12,0,0.94
barcode13,5,70925206,T,DEL,1167,3,1,2,0.26
barcode13,5,70925207,C,DEL,1117,10,1,9,0.9
barcode13,5,70925208,T,DEL,1100,3,2,1,0.27
barcode13,5,70925209,C,DEL,1089,2,2,0,0.18
barcode13,5,70925211,C,DEL,995,2,2,0,0.2
barcode13,5,70925212,T,DEL,967,5,5,0,0.52
barcode13,5,70925213,A,DEL,493,15,15,0,3.04
barcode13,5,70938753,G,DEL,8,1,1,0,12.5
barcode13,5,70938766,T,DEL,487,1,0,1,0.21
barcode13,5,70938767,C,DEL,511,17,0,17,3.33
barcode13,5,70938768,T,DEL,578,30,1,29,5.19
barcode13,5,70938769,T,DEL,587,2,0,2,0.34
barcode13,5,70938770,G,DEL,590,3,0,3,0.51
barcode13,5,70938772,T,DEL,619,12,0,12,1.94
barcode13,5,70938773,A,DEL,633,1,1,0,0.16
barcode13,5,70938774,C,DEL,635,3,2,1,0.47
barcode13,5,70938776,A,DEL,659,10,0,10,1.52
barcode13,5,70938780,T,DEL,682,1,0,1,0.15
barcode13,5,70938781,A,DEL,689,5,5,0,0.73
barcode13,5,70938782,C,DEL,690,4,2,2,0.58
barcode13,5,70938783,A,DEL,695,6,1,5,0.86
barcode13,5,70938784,T,DEL,695,31,18,13,4.46
barcode13,5,70938785,T,DEL,704,2,0,2,0.28
barcode13,5,70938787,T,DEL,719,2,2,0,0.28
barcode13,5,70938788,C,DEL,728,6,4,2,0.82
barcode13,5,70938789,T,DEL,729,2,0,2,0.27
barcode13,5,70938790,G,DEL,734,16,1,15,2.18
barcode13,5,70938791,A,DEL,737,1,1,0,0.14
barcode13,5,70938792,T,DEL,740,1,1,0,0.14
barcode13,5,70938794,A,DEL,744,16,0,16,2.15
barcode13,5,70938798,C,DEL,819,1,0,1,0.12
barcode13,5,70938799,T,DEL,820,6,1,5,0.73
barcode13,5,70938800,A,DEL,824,1,1,0,0.12
barcode13,5,70938801,T,DEL,824,3,0,3,0.36
barcode13,5,70938803,T,DEL,846,3,0,3,0.35
barcode13,5,70938804,G,DEL,846,17,0,17,2.01
barcode13,5,70938805,A,DEL,853,38,0,38,4.45
barcode13,5,70938806,A,DEL,860,1,0,1,0.12
barcode13,5,70938807,C,DEL,899,1,0,1,0.11
barcode13,5,70938808,A,DEL,911,7,0,7,0.77
barcode13,5,70938809,T,DEL,914,1,0,1,0.11
barcode13,5,70938811,A,DEL,954,1,1,0,0.1
barcode13,5,70938812,G,DEL,956,1,1,0,0.1
barcode13,5,70938813,T,DEL,967,1,1,0,0.1
barcode13,5,70938814,T,DEL,970,1,1,0,0.1
barcode13,5,70938815,G,DEL,980,2,2,0,0.2
barcode13,5,70938816,T,DEL,985,87,59,28,8.83
barcode13,5,70938817,T,DEL,989,37,36,1,3.74
barcode13,5,70938818,T,DEL,994,2,2,0,0.2
barcode13,5,70938819,T,DEL,994,3,3,0,0.3
barcode13,5,70938820,T,DEL,994,3,3,0,0.3
barcode13,5,70938821,A,DEL,996,4,4,0,0.4
barcode13,5,70938822,T,DEL,1000,10,3,7,1.0
barcode13,5,70938823,T,DEL,1006,2,2,0,0.2
barcode13,5,70938824,T,DEL,1008,3,3,0,0.3
barcode13,5,70938825,C,DEL,1016,4,4,0,0.39
barcode13,5,70938826,T,DEL,1020,12,11,1,1.18
barcode13,5,70938828,A,DEL,1031,2,1,1,0.19
barcode13,5,70938829,C,DEL,1032,17,2,15,1.65
barcode13,5,70938830,C,DEL,1033,1,1,0,0.1
barcode13,5,70938831,C,DEL,1034,3,3,0,0.29
barcode13,5,70938832,T,DEL,1036,19,17,2,1.83
barcode13,5,70938833,T,DEL,1042,2,2,0,0.19
barcode13,5,70938834,T,DEL,1047,1,1,0,0.1
barcode13,5,70938835,C,DEL,1050,2,2,0,0.19
barcode13,5,70938837,A,DEL,1052,5,3,2,0.48
barcode13,5,70938838,G,DEL,1055,2,0,2,0.19
barcode13,5,70938841,C,DEL,1046,1,1,0,0.1
barcode13,5,70938847,T,DEL,1041,8,4,4,0.77
barcode13,5,70938848,T,DEL,1046,4,4,0,0.38
barcode13,5,70938849,C,DEL,1060,8,4,4,0.75
barcode13,5,70938850,T,DEL,1064,3,2,1,0.28
barcode13,5,70938851,G,DEL,1065,12,0,12,1.13
barcode13,5,70938855,T,DEL,1061,14,8,6,1.32
barcode13,5,70938858,G,DEL,1080,44,2,42,4.07
barcode13,5,70938862,T,DEL,1080,1,1,0,0.09
barcode13,5,70938863,G,DEL,1075,1,1,0,0.09
barcode13,5,70938864,A,DEL,1084,1,0,1,0.09
barcode13,5,70938865,T,DEL,1073,1,0,1,0.09
barcode13,5,70938866,A,DEL,1105,4,4,0,0.36
barcode13,5,70938869,G,DEL,1099,5,0,5,0.45
barcode13,5,70938873,T,DEL,1076,1,0,1,0.09
barcode13,5,70938874,G,DEL,1061,2,0,2,0.19
barcode13,5,70938875,A,DEL,1056,1,0,1,0.09
barcode13,5,70938876,T,DEL,1051,1,0,1,0.1
barcode13,5,70938877,A,DEL,1011,52,40,12,5.14
barcode13,5,70938878,A,DEL,1012,1,0,1,0.1
barcode13,5,70938879,A,DEL,1015,1,0,1,0.1
barcode13,5,70938880,A,DEL,1007,1,0,1,0.1
barcode13,5,70938881,G,DEL,1002,1,0,1,0.1
barcode13,5,70938882,C,DEL,998,1,1,0,0.1
barcode13,5,70938887,G,DEL,984,2,1,1,0.2
barcode13,5,70938890,A,DEL,956,4,1,3,0.42
barcode13,5,70938893,G,DEL,944,1,1,0,0.11
barcode13,5,70938898,G,DEL,887,1,1,0,0.11
barcode13,5,70938900,C,DEL,868,5,0,5,0.58
barcode13,5,70938901,T,DEL,868,6,6,0,0.69
barcode13,5,70938904,A,DEL,835,1,1,0,0.12
barcode13,5,70938905,T,DEL,835,13,2,11,1.56
barcode13,5,70938907,T,DEL,829,2,0,2,0.24
barcode13,5,70938908,A,DEL,825,12,2,10,1.45
barcode13,5,70938909,A,DEL,821,1,1,0,0.12
barcode13,5,70938912,T,DEL,800,3,1,2,0.38
barcode13,5,70938913,A,DEL,792,2,1,1,0.25
barcode13,5,70938916,A,DEL,768,4,1,3,0.52
barcode13,5,70938919,T,DEL,757,11,11,0,1.45
barcode13,5,70938920,G,DEL,753,11,11,0,1.46
barcode13,5,70938921,C,DEL,748,12,11,1,1.6
barcode13,5,70938922,T,DEL,746,14,14,0,1.88
barcode13,5,70938923,T,DEL,740,3,3,0,0.41
barcode13,5,70938924,G,DEL,730,8,8,0,1.1
barcode13,5,70938925,C,DEL,705,10,3,7,1.42
barcode13,5,70938926,T,DEL,703,6,2,4,0.85
barcode13,5,70938928,A,DEL,674,1,1,0,0.15
barcode13,5,70938929,G,DEL,667,3,3,0,0.45
barcode13,5,70938931,C,DEL,653,2,2,0,0.31
barcode13,5,70938932,G,DEL,653,2,2,0,0.31
barcode13,5,70938933,T,DEL,652,41,38,3,6.29
barcode13,5,70938934,T,DEL,652,3,2,1,0.46
barcode13,5,70938935,T,DEL,635,3,3,0,0.47
barcode13,5,70938936,T,DEL,630,4,4,0,0.63
barcode13,5,70938937,C,DEL,625,5,5,0,0.8
barcode13,5,70938938,T,DEL,625,4,2,2,0.64
barcode13,5,70938939,T,DEL,623,2,0,2,0.32
barcode13,5,70938940,A,DEL,619,2,2,0,0.32
barcode13,5,70938941,T,DEL,619,67,67,0,10.82
barcode13,5,70938944,T,DEL,593,6,6,0,1.01
barcode13,5,70938945,C,DEL,588,9,9,0,1.53
barcode13,5,70938947,C,DEL,560,2,0,2,0.36
barcode13,5,70938956,T,DEL,10,1,1,0,10.0
barcode13,5,70941358,A,DEL,300,4,0,4,1.33
barcode13,5,70941363,G,DEL,431,1,0,1,0.23
barcode13,5,70941364,T,DEL,488,1,0,1,0.2
barcode13,5,70941366,C,DEL,505,1,0,1,0.2
barcode13,5,70941368,T,DEL,515,121,3,118,23.5
barcode13,5,70941374,T,DEL,544,1,1,0,0.18
barcode13,5,70941377,C,DEL,558,1,0,1,0.18
barcode13,5,70941378,T,DEL,559,19,1,18,3.4
barcode13,5,70941379,A,DEL,570,1,1,0,0.18
barcode13,5,70941380,T,DEL,577,42,5,37,7.28
barcode13,5,70941381,T,DEL,583,8,0,8,1.37
barcode13,5,70941382,T,DEL,593,1,0,1,0.17
barcode13,5,70941383,T,DEL,600,6,0,6,1.0
barcode13,5,70941384,C,DEL,614,72,0,72,11.73
barcode13,5,70941385,G,DEL,632,1,0,1,0.16
barcode13,5,70941386,T,DEL,635,37,0,37,5.83
barcode13,5,70941389,C,DEL,660,1,0,1,0.15
barcode13,5,70941390,A,DEL,667,2,2,0,0.3
barcode13,5,70941393,C,DEL,686,3,1,2,0.44
barcode13,5,70941394,T,DEL,713,2,1,1,0.28
barcode13,5,70941395,C,DEL,727,10,1,9,1.38
barcode13,5,70941396,T,DEL,734,33,0,33,4.5
barcode13,5,70941397,A,DEL,746,44,0,44,5.9
barcode13,5,70941398,A,DEL,747,3,0,3,0.4
barcode13,5,70941399,A,DEL,749,1,0,1,0.13
barcode13,5,70941400,G,DEL,751,3,0,3,0.4
barcode13,5,70941401,A,DEL,764,11,11,0,1.44
barcode13,5,70941402,A,DEL,767,1,1,0,0.13
barcode13,5,70941403,T,DEL,767,1,1,0,0.13
barcode13,5,70941404,G,DEL,770,3,1,2,0.39
barcode13,5,70941405,G,DEL,798,1,1,0,0.13
barcode13,5,70941406,T,DEL,801,2,1,1,0.25
barcode13,5,70941407,G,DEL,806,3,2,1,0.37
barcode13,5,70941408,A,DEL,808,6,0,6,0.74
barcode13,5,70941409,C,DEL,817,1,0,1,0.12
barcode13,5,70941411,T,DEL,833,7,4,3,0.84
barcode13,5,70941413,T,DEL,840,15,15,0,1.79
barcode13,5,70941414,G,DEL,846,19,19,0,2.25
barcode13,5,70941415,T,DEL,849,3,3,0,0.35
barcode13,5,70941416,G,DEL,849,6,2,4,0.71
barcode13,5,70941417,A,DEL,852,53,11,42,6.22
barcode13,5,70941418,A,DEL,854,1,0,1,0.12
barcode13,5,70941421,T,DEL,881,22,22,0,2.5
barcode13,5,70941423,C,DEL,925,15,15,0,1.62
barcode13,5,70941424,G,DEL,955,45,1,44,4.71
barcode13,5,70941426,G,DEL,957,2,0,2,0.21
barcode13,5,70941427,T,DEL,962,6,0,6,0.62
barcode13,5,70941428,A,DEL,967,20,5,15,2.07
barcode13,5,70941429,A,DEL,997,1,0,1,0.1
barcode13,5,70941430,A,DEL,1001,2,0,2,0.2
barcode13,5,70941431,C,DEL,1003,18,10,8,1.79
barcode13,5,70941432,C,DEL,1004,2,0,2,0.2
barcode13,5,70941433,A,DEL,1007,124,14,110,12.31
barcode13,5,70941434,A,DEL,1014,7,2,5,0.69
barcode13,5,70941435,A,DEL,1014,1,0,1,0.1
barcode13,5,70941437,A,DEL,1019,1,1,0,0.1
barcode13,5,70941438,C,DEL,1021,3,3,0,0.29
barcode13,5,70941439,C,DEL,1025,3,2,1,0.29
barcode13,5,70941440,A,DEL,1030,2,1,1,0.19
barcode13,5,70941441,C,DEL,1035,1,0,1,0.1
barcode13,5,70941442,A,DEL,1036,1,0,1,0.1
barcode13,5,70941443,C,DEL,1038,3,0,3,0.29
barcode13,5,70941444,C,DEL,1036,1,0,1,0.1
barcode13,5,70941445,T,DEL,1035,5,1,4,0.48
barcode13,5,70941446,A,DEL,1030,101,9,92,9.81
barcode13,5,70941447,A,DEL,1034,4,1,3,0.39
barcode13,5,70941448,A,DEL,1032,2,1,1,0.19
barcode13,5,70941449,A,DEL,1032,6,1,5,0.58
barcode13,5,70941450,G,DEL,1030,8,2,6,0.78
barcode13,5,70941451,A,DEL,1027,14,2,12,1.36
barcode13,5,70941452,A,DEL,1028,1,0,1,0.1
barcode13,5,70941453,A,DEL,1033,1,0,1,0.1
barcode13,5,70941454,A,DEL,1043,1,0,1,0.1
barcode13,5,70941455,C,DEL,1042,2,1,1,0.19
barcode13,5,70941457,T,DEL,1049,1,0,1,0.1
barcode13,5,70941458,G,DEL,1059,6,6,0,0.57
barcode13,5,70941459,C,DEL,1059,4,2,2,0.38
barcode13,5,70941460,T,DEL,1059,4,2,2,0.38
barcode13,5,70941461,A,DEL,1055,74,62,12,7.01
barcode13,5,70941462,A,DEL,1057,47,36,11,4.45
barcode13,5,70941463,G,DEL,1054,47,36,11,4.46
barcode13,5,70941464,A,DEL,1055,25,24,1,2.37
barcode13,5,70941465,A,DEL,1060,25,25,0,2.36
barcode13,5,70941466,G,DEL,1051,36,35,1,3.43
barcode13,5,70941467,A,DEL,1044,15,9,6,1.44
barcode13,5,70941468,A,DEL,1044,7,1,6,0.67
barcode13,5,70941469,T,DEL,1042,6,0,6,0.58
barcode13,5,70941470,A,DEL,1032,42,10,32,4.07
barcode13,5,70941471,A,DEL,1030,2,0,2,0.19
barcode13,5,70941475,C,DEL,1026,3,3,0,0.29
barcode13,5,70941477,A,DEL,1020,150,20,130,14.71
barcode13,5,70941478,A,DEL,1013,14,2,12,1.38
barcode13,5,70941479,A,DEL,1006,17,14,3,1.69
barcode13,5,70941480,A,DEL,1000,21,15,6,2.1
barcode13,5,70941481,G,DEL,995,24,16,8,2.41
barcode13,5,70941482,A,DEL,988,32,3,29,3.24
barcode13,5,70941483,A,DEL,986,10,9,1,1.01
barcode13,5,70941484,G,DEL,982,12,11,1,1.22
barcode13,5,70941485,A,DEL,973,52,42,10,5.34
barcode13,5,70941486,A,DEL,969,3,3,0,0.31
barcode13,5,70941488,A,DEL,950,3,3,0,0.32
barcode13,5,70941489,C,DEL,949,1,1,0,0.11
barcode13,5,70941490,T,DEL,947,1,0,1,0.11
barcode13,5,70941491,G,DEL,946,2,0,2,0.21
barcode13,5,70941492,C,DEL,943,2,0,2,0.21
barcode13,5,70941495,C,DEL,904,35,0,35,3.87
barcode13,5,70941496,T,DEL,901,44,37,7,4.88
barcode13,5,70941500,T,DEL,865,48,48,0,5.55
barcode13,5,70941502,A,DEL,832,8,8,0,0.96
barcode13,5,70941504,A,DEL,782,1,0,1,0.13
barcode13,5,70941507,A,DEL,761,1,1,0,0.13
barcode13,5,70941513,T,DEL,720,21,18,3,2.92
barcode13,5,70941516,T,DEL,707,1,1,0,0.14
barcode13,5,70941517,A,DEL,700,16,8,8,2.29
barcode13,5,70941523,T,DEL,688,49,49,0,7.12
barcode13,5,70941524,T,DEL,682,1,1,0,0.15
barcode13,5,70941525,G,DEL,670,12,12,0,1.79
barcode13,5,70941527,G,DEL,642,7,6,1,1.09
barcode13,5,70941529,T,DEL,612,16,14,2,2.61
barcode13,5,70941532,A,DEL,603,1,0,1,0.17
barcode13,5,70941534,C,DEL,596,1,0,1,0.17
barcode13,5,70941535,T,DEL,596,21,21,0,3.52
barcode13,5,70941538,A,DEL,563,4,0,4,0.71
barcode13,5,70941541,G,DEL,534,2,2,0,0.37
barcode13,5,70942312,T,DEL,42,1,1,0,2.38
barcode13,5,70942320,A,DEL,148,2,0,2,1.35
barcode13,5,70942323,T,DEL,175,1,1,0,0.57
barcode13,5,70942324,G,DEL,190,1,1,0,0.53
barcode13,5,70942329,C,DEL,200,1,0,1,0.5
barcode13,5,70942333,T,DEL,206,11,4,7,5.34
barcode13,5,70942334,A,DEL,209,10,4,6,4.78
barcode13,5,70942339,T,DEL,215,3,0,3,1.4
barcode13,5,70942341,T,DEL,217,27,22,5,12.44
barcode13,5,70942342,T,DEL,443,1,0,1,0.23
barcode13,5,70942343,T,DEL,443,1,0,1,0.23
barcode13,5,70942344,G,DEL,444,4,0,4,0.9
barcode13,5,70942345,A,DEL,451,1,0,1,0.22
barcode13,5,70942346,T,DEL,451,1,1,0,0.22
barcode13,5,70942350,T,DEL,464,41,34,7,8.84
barcode13,5,70942351,T,DEL,467,1,1,0,0.21
barcode13,5,70942352,T,DEL,467,1,1,0,0.21
barcode13,5,70942353,T,DEL,467,1,1,0,0.21
barcode13,5,70942354,G,DEL,616,2,1,1,0.32
barcode13,5,70942355,T,DEL,631,2,0,2,0.32
barcode13,5,70942361,A,DEL,726,43,12,31,5.92
barcode13,5,70942362,A,DEL,726,1,1,0,0.14
barcode13,5,70942365,T,DEL,730,3,3,0,0.41
barcode13,5,70942367,G,DEL,752,32,16,16,4.26
barcode13,5,70942368,G,DEL,759,2,1,1,0.26
barcode13,5,70942369,G,DEL,760,2,1,1,0.26
barcode13,5,70942370,G,DEL,761,2,1,1,0.26
barcode13,5,70942371,A,DEL,762,2,1,1,0.26
barcode13,5,70942372,C,DEL,763,4,1,3,0.52
barcode13,5,70942373,A,DEL,765,10,1,9,1.31
barcode13,5,70942375,A,DEL,765,2,2,0,0.26
barcode13,5,70942376,T,DEL,765,3,3,0,0.39
barcode13,5,70942377,G,DEL,765,3,2,1,0.39
barcode13,5,70942378,T,DEL,771,6,4,2,0.78
barcode13,5,70942379,T,DEL,771,2,2,0,0.26
barcode13,5,70942380,C,DEL,773,5,2,3,0.65
barcode13,5,70942381,T,DEL,775,2,1,1,0.26
barcode13,5,70942382,G,DEL,779,2,2,0,0.26
barcode13,5,70942383,C,DEL,782,2,1,1,0.26
barcode13,5,70942384,C,DEL,783,1,0,1,0.13
barcode13,5,70942385,A,DEL,785,2,2,0,0.25
barcode13,5,70942386,T,DEL,785,21,21,0,2.68
barcode13,5,70942387,T,DEL,786,2,2,0,0.25
barcode13,5,70942388,T,DEL,784,3,3,0,0.38
barcode13,5,70942389,G,DEL,784,3,3,0,0.38
barcode13,5,70942390,G,DEL,785,3,3,0,0.38
barcode13,5,70942392,C,DEL,784,11,11,0,1.4
barcode13,5,70942393,A,DEL,787,7,1,6,0.89
barcode13,5,70942394,G,DEL,788,6,0,6,0.76
barcode13,5,70942395,A,DEL,795,2,2,0,0.25
barcode13,5,70942397,G,DEL,794,1,1,0,0.13
barcode13,5,70942398,A,DEL,794,34,34,0,4.28
barcode13,5,70942399,C,DEL,795,3,3,0,0.38
barcode13,5,70942400,G,DEL,795,2,1,1,0.25
barcode13,5,70942401,G,DEL,796,1,1,0,0.13
barcode13,5,70942402,T,DEL,796,81,81,0,10.18
barcode13,5,70942403,T,DEL,796,1,1,0,0.13
barcode13,5,70942404,G,DEL,795,1,1,0,0.13
barcode13,5,70942405,C,DEL,796,2,2,0,0.25
barcode13,5,70942406,A,DEL,796,1,1,0,0.13
barcode13,5,70942407,T,DEL,796,41,35,6,5.15
barcode13,5,70942408,T,DEL,804,3,3,0,0.37
barcode13,5,70942409,T,DEL,803,1,1,0,0.12
barcode13,5,70942410,A,DEL,816,1,1,0,0.12
barcode13,5,70942411,C,DEL,816,28,28,0,3.43
barcode13,5,70942413,C,DEL,822,1,0,1,0.12
barcode13,5,70942414,A,DEL,823,1,0,1,0.12
barcode13,5,70942415,G,DEL,823,1,1,0,0.12
barcode13,5,70942417,T,DEL,820,1,1,0,0.12
barcode13,5,70942418,A,DEL,822,10,9,1,1.22
barcode13,5,70942419,C,DEL,822,6,5,1,0.73
barcode13,5,70942420,C,DEL,826,4,4,0,0.48
barcode13,5,70942421,A,DEL,829,1,1,0,0.12
barcode13,5,70942422,T,DEL,829,3,3,0,0.36
barcode13,5,70942424,G,DEL,853,3,3,0,0.35
barcode13,5,70942425,C,DEL,857,3,3,0,0.35
barcode13,5,70942426,T,DEL,859,36,36,0,4.19
barcode13,5,70942429,A,DEL,894,2,1,1,0.22
barcode13,5,70942431,T,DEL,893,2,2,0,0.22
barcode13,5,70942433,G,DEL,890,1,1,0,0.11
barcode13,5,70942435,T,DEL,890,35,33,2,3.93
barcode13,5,70942436,T,DEL,888,3,3,0,0.34
barcode13,5,70942437,T,DEL,879,15,15,0,1.71
barcode13,5,70942438,T,DEL,872,72,72,0,8.26
barcode13,5,70942439,A,DEL,874,135,132,3,15.45
barcode13,5,70942440,A,DEL,876,82,82,0,9.36
barcode13,5,70942441,G,DEL,875,59,59,0,6.74
barcode13,5,70942442,A,DEL,881,30,30,0,3.41
barcode13,5,70942443,G,DEL,884,5,5,0,0.57
barcode13,5,70942444,A,DEL,889,20,20,0,2.25
barcode13,5,70942445,G,DEL,883,9,8,1,1.02
barcode13,5,70942446,A,DEL,881,13,12,1,1.48
barcode13,5,70942451,T,DEL,914,7,7,0,0.77
barcode13,5,70942452,G,DEL,914,8,8,0,0.88
barcode13,5,70942455,T,DEL,910,1,1,0,0.11
barcode13,5,70942456,T,DEL,909,1,1,0,0.11
barcode13,5,70942457,G,DEL,928,1,1,0,0.11
barcode13,5,70942459,G,DEL,934,1,1,0,0.11
barcode13,5,70942461,T,DEL,931,1,1,0,0.11
barcode13,5,70942466,A,DEL,969,1,0,1,0.1
barcode13,5,70942467,C,DEL,970,1,1,0,0.1
barcode13,5,70942468,T,DEL,969,1,1,0,0.1
barcode13,5,70942469,G,DEL,969,2,1,1,0.21
barcode13,5,70942470,G,DEL,966,1,1,0,0.1
barcode13,5,70942471,A,DEL,967,1,1,0,0.1
barcode13,5,70942475,G,DEL,966,2,2,0,0.21
barcode13,5,70942477,A,DEL,963,2,0,2,0.21
barcode13,5,70942480,T,DEL,964,3,2,1,0.31
barcode13,5,70942481,A,DEL,953,28,26,2,2.94
barcode13,5,70942482,G,DEL,954,10,7,3,1.05
barcode13,5,70942483,A,DEL,952,11,11,0,1.16
barcode13,5,70942484,G,DEL,951,14,14,0,1.47
barcode13,5,70942485,A,DEL,952,14,14,0,1.47
barcode13,5,70942486,G,DEL,946,65,64,1,6.87
barcode13,5,70942487,G,DEL,945,11,11,0,1.16
barcode13,5,70942488,A,DEL,944,12,12,0,1.27
barcode13,5,70942489,G,DEL,944,4,3,1,0.42
barcode13,5,70942490,C,DEL,944,3,2,1,0.32
barcode13,5,70942491,A,DEL,944,18,17,1,1.91
barcode13,5,70942494,A,DEL,941,3,1,2,0.32
barcode13,5,70942495,T,DEL,939,13,7,6,1.38
barcode13,5,70942496,C,DEL,932,8,8,0,0.86
barcode13,5,70942497,T,DEL,932,2,1,1,0.21
barcode13,5,70942498,G,DEL,927,1,1,0,0.11
barcode13,5,70942499,T,DEL,927,13,13,0,1.4
barcode13,5,70942500,C,DEL,928,3,3,0,0.32
barcode13,5,70942502,G,DEL,926,4,0,4,0.43
barcode13,5,70942504,T,DEL,924,4,4,0,0.43
barcode13,5,70942505,C,DEL,914,6,6,0,0.66
barcode13,5,70942506,T,DEL,914,4,1,3,0.44
barcode13,5,70942507,A,DEL,915,3,3,0,0.33
barcode13,5,70942508,C,DEL,919,6,6,0,0.65
barcode13,5,70942509,T,DEL,919,37,34,3,4.03
barcode13,5,70942510,T,DEL,926,2,1,1,0.22
barcode13,5,70942511,T,DEL,925,134,130,4,14.49
barcode13,5,70942512,C,DEL,926,371,367,4,40.06
barcode13,5,70942513,C,DEL,982,39,39,0,3.97
barcode13,5,70942515,C,DEL,986,1,1,0,0.1
barcode13,5,70942516,A,DEL,984,2,2,0,0.2
barcode13,5,70942518,T,DEL,989,1,1,0,0.1
barcode13,5,70942519,C,DEL,1018,3,3,0,0.29
barcode13,5,70942520,T,DEL,1016,1,1,0,0.1
barcode13,5,70942521,G,DEL,1016,1,1,0,0.1
barcode13,5,70942522,T,DEL,1016,10,10,0,0.98
barcode13,5,70942524,A,DEL,1016,3,0,3,0.3
barcode13,5,70942530,C,DEL,1006,1,0,1,0.1
barcode13,5,70942531,T,DEL,1006,4,2,2,0.4
barcode13,5,70942532,A,DEL,997,6,2,4,0.6
barcode13,5,70942533,A,DEL,995,3,2,1,0.3
barcode13,5,70942535,A,DEL,990,3,2,1,0.3
barcode13,5,70942536,A,DEL,987,7,7,0,0.71
barcode13,5,70942537,T,DEL,986,5,5,0,0.51
barcode13,5,70942538,A,DEL,972,1,1,0,0.1
barcode13,5,70942540,A,DEL,967,2,2,0,0.21
barcode13,5,70942541,G,DEL,965,9,9,0,0.93
barcode13,5,70942542,A,DEL,965,4,2,2,0.41
barcode13,5,70942543,A,DEL,959,1,1,0,0.1
barcode13,5,70942544,C,DEL,954,1,1,0,0.1
barcode13,5,70942545,A,DEL,940,5,5,0,0.53
barcode13,5,70942546,A,DEL,936,1,1,0,0.11
barcode13,5,70942550,G,DEL,934,1,1,0,0.11
barcode13,5,70942553,C,DEL,918,3,3,0,0.33
barcode13,5,70942554,A,DEL,917,2,0,2,0.22
barcode13,5,70942557,A,DEL,908,27,27,0,2.97
barcode13,5,70942563,G,DEL,885,1,1,0,0.11
barcode13,5,70942565,A,DEL,869,1,1,0,0.12
barcode13,5,70942567,A,DEL,851,1,1,0,0.12
barcode13,5,70942568,C,DEL,844,1,1,0,0.12
barcode13,5,70942569,A,DEL,826,132,132,0,15.98
barcode13,5,70942570,A,DEL,825,102,102,0,12.36
barcode13,5,70942571,A,DEL,822,60,60,0,7.3
barcode13,5,70942572,A,DEL,817,13,13,0,1.59
barcode13,5,70942573,A,DEL,798,3,3,0,0.38
barcode13,5,70942678,A,DEL,320,3,0,3,0.94
barcode13,5,70942679,C,DEL,371,1,0,1,0.27
barcode13,5,70942682,T,DEL,415,2,1,1,0.48
barcode13,5,70942686,A,DEL,430,2,0,2,0.47
barcode13,5,70942687,A,DEL,430,2,0,2,0.47
barcode13,5,70942688,C,DEL,431,2,0,2,0.46
barcode13,5,70942689,A,DEL,432,20,5,15,4.63
barcode13,5,70942696,T,DEL,443,3,0,3,0.68
barcode13,5,70942699,A,DEL,445,1,0,1,0.22
barcode13,5,70942700,T,DEL,447,2,0,2,0.45
barcode13,5,70942701,A,DEL,448,3,0,3,0.67
barcode13,5,70942702,T,DEL,449,13,1,12,2.9
barcode13,5,70942703,T,DEL,449,3,0,3,0.67
barcode13,5,70942704,T,DEL,451,2,0,2,0.44
barcode13,5,70942705,T,DEL,454,2,0,2,0.44
barcode13,5,70942706,T,DEL,455,7,0,7,1.54
barcode13,5,70942707,T,DEL,456,14,0,14,3.07
barcode13,5,70942708,C,DEL,459,19,0,19,4.14
barcode13,5,70942709,T,DEL,461,63,2,61,13.67
barcode13,5,70942710,T,DEL,464,7,0,7,1.51
barcode13,5,70942711,T,DEL,465,1,0,1,0.22
barcode13,5,70942712,T,DEL,465,1,0,1,0.22
barcode13,5,70942713,T,DEL,466,6,0,6,1.29
barcode13,5,70942714,A,DEL,473,17,0,17,3.59
barcode13,5,70942717,G,DEL,481,1,0,1,0.21
barcode13,5,70942718,A,DEL,482,8,0,8,1.66
barcode13,5,70942721,G,DEL,482,4,0,4,0.83
barcode13,5,70942722,A,DEL,482,53,9,44,11.0
barcode13,5,70942723,A,DEL,483,3,0,3,0.62
barcode13,5,70942724,A,DEL,484,1,0,1,0.21
barcode13,5,70942725,A,DEL,484,1,0,1,0.21
barcode13,5,70942726,T,DEL,484,2,0,2,0.41
barcode13,5,70942727,G,DEL,484,44,0,44,9.09
barcode13,5,70942728,A,DEL,489,2,0,2,0.41
barcode13,5,70942729,A,DEL,489,1,0,1,0.2
barcode13,5,70942730,A,DEL,488,1,0,1,0.2
barcode13,5,70942731,G,DEL,488,1,0,1,0.2
barcode13,5,70942732,C,DEL,489,1,0,1,0.2
barcode13,5,70942733,C,DEL,493,1,0,1,0.2
barcode13,5,70942734,A,DEL,493,12,0,12,2.43
barcode13,5,70942736,G,DEL,490,2,0,2,0.41
barcode13,5,70942737,T,DEL,491,4,0,4,0.81
barcode13,5,70942741,A,DEL,499,5,0,5,1.0
barcode13,5,70942743,C,DEL,503,5,0,5,0.99
barcode13,5,70942745,G,DEL,503,1,0,1,0.2
barcode13,5,70942748,G,DEL,504,1,0,1,0.2
barcode13,5,70942749,A,DEL,505,47,0,47,9.31
barcode13,5,70942750,A,DEL,505,1,0,1,0.2
barcode13,5,70942751,A,DEL,504,1,0,1,0.2
barcode13,5,70942754,G,DEL,504,1,0,1,0.2
barcode13,5,70942755,A,DEL,503,1,0,1,0.2
barcode13,5,70942756,G,DEL,502,3,2,1,0.6
barcode13,5,70942757,A,DEL,505,18,1,17,3.56
barcode13,5,70942758,A,DEL,508,1,1,0,0.2
barcode13,5,70942759,C,DEL,509,2,1,1,0.39
barcode13,5,70942761,C,DEL,525,4,1,3,0.76
barcode13,5,70942762,C,DEL,527,1,0,1,0.19
barcode13,5,70942763,A,DEL,528,1,0,1,0.19
barcode13,5,70942764,G,DEL,529,6,5,1,1.13
barcode13,5,70942765,G,DEL,524,1,0,1,0.19
barcode13,5,70942766,T,DEL,524,16,0,16,3.05
barcode13,5,70942767,C,DEL,524,33,0,33,6.3
barcode13,5,70942768,T,DEL,531,6,1,5,1.13
barcode13,5,70942769,C,DEL,538,4,0,4,0.74
barcode13,5,70942770,C,DEL,550,3,0,3,0.55
barcode13,5,70942771,T,DEL,551,3,0,3,0.54
barcode13,5,70942772,G,DEL,552,8,1,7,1.45
barcode13,5,70942773,G,DEL,552,2,0,2,0.36
barcode13,5,70942774,A,DEL,553,10,0,10,1.81
barcode13,5,70942775,A,DEL,549,1,0,1,0.18
barcode13,5,70942776,A,DEL,548,1,0,1,0.18
barcode13,5,70942777,T,DEL,546,3,0,3,0.55
barcode13,5,70942778,A,DEL,546,1,0,1,0.18
barcode13,5,70942785,A,DEL,436,4,0,4,0.92
barcode13,5,70942786,T,DEL,437,5,0,5,1.14
barcode13,5,70942787,A,DEL,403,1,0,1,0.25
barcode13,5,70942793,A,DEL,403,3,0,3,0.74
barcode13,5,70942796,C,DEL,403,9,8,1,2.23
barcode13,5,70942798,C,DEL,387,2,0,2,0.52
barcode13,5,70942799,A,DEL,372,4,1,3,1.08
barcode13,5,70942800,A,DEL,375,1,0,1,0.27
barcode13,5,70942802,T,DEL,373,8,0,8,2.14
barcode13,5,70942803,C,DEL,373,9,0,9,2.41
barcode13,5,70942808,C,DEL,417,3,1,2,0.72
barcode13,5,70942812,G,DEL,417,2,2,0,0.48
barcode13,5,70942814,A,DEL,416,2,0,2,0.48
barcode13,5,70942816,C,DEL,406,2,0,2,0.49
barcode13,5,70942817,T,DEL,406,3,0,3,0.74
barcode13,5,70942818,C,DEL,407,5,1,4,1.23
barcode13,5,70942819,T,DEL,407,34,4,30,8.35
barcode13,5,70942820,T,DEL,406,4,0,4,0.99
barcode13,5,70942821,T,DEL,402,7,1,6,1.74
barcode13,5,70942822,T,DEL,393,27,1,26,6.87
barcode13,5,70942823,C,DEL,391,42,3,39,10.74
barcode13,5,70942824,T,DEL,389,39,3,36,10.03
barcode13,5,70942825,C,DEL,391,70,8,62,17.9
barcode13,5,70942826,C,DEL,396,32,1,31,8.08
barcode13,5,70942827,C,DEL,393,14,0,14,3.56
barcode13,5,70942828,T,DEL,394,15,1,14,3.81
barcode13,5,70942829,C,DEL,393,24,0,24,6.11
barcode13,5,70942830,C,DEL,398,9,0,9,2.26
barcode13,5,70942831,A,DEL,399,2,0,2,0.5
barcode13,5,70942832,C,DEL,398,3,2,1,0.75
barcode13,5,70942833,C,DEL,398,4,2,2,1.01
barcode13,5,70942834,A,DEL,398,4,2,2,1.01
barcode13,5,70942835,C,DEL,399,88,63,25,22.06
barcode13,5,70942836,C,DEL,384,5,3,2,1.3
barcode13,5,70942837,C,DEL,383,2,1,1,0.52
barcode13,5,70942838,C,DEL,382,2,1,1,0.52
barcode13,5,70942839,C,DEL,379,1,0,1,0.26
barcode13,5,70942840,C,DEL,380,1,0,1,0.26
barcode13,5,70942841,A,DEL,380,1,0,1,0.26
barcode13,5,70942842,T,DEL,380,1,0,1,0.26
barcode13,5,70942844,C,DEL,382,6,5,1,1.57
barcode13,5,70942847,G,DEL,383,2,2,0,0.52
barcode13,5,70942850,C,DEL,384,1,1,0,0.26
barcode13,5,70942852,A,DEL,384,24,7,17,6.25
barcode13,5,70942853,A,DEL,383,1,0,1,0.26
barcode13,5,70942854,G,DEL,384,2,0,2,0.52
barcode13,5,70942856,C,DEL,383,1,0,1,0.26
barcode13,5,70942857,T,DEL,383,13,0,13,3.39
barcode13,5,70942858,G,DEL,382,19,1,18,4.97
barcode13,5,70942859,G,DEL,382,1,0,1,0.26
barcode13,5,70942860,G,DEL,380,1,0,1,0.26
barcode13,5,70942861,A,DEL,382,1,0,1,0.26
barcode13,5,70942862,C,DEL,382,1,0,1,0.26
barcode13,5,70942864,A,DEL,382,1,0,1,0.26
barcode13,5,70942865,G,DEL,380,1,0,1,0.26
barcode13,5,70942866,G,DEL,368,1,0,1,0.27
barcode13,5,70942867,A,DEL,365,23,5,18,6.3
barcode13,5,70942868,A,DEL,365,2,0,2,0.55
barcode13,5,70942870,G,DEL,361,2,0,2,0.55
barcode13,5,70942872,T,DEL,363,3,0,3,0.83
barcode13,5,70942873,A,DEL,361,4,0,4,1.11
barcode13,5,70942874,A,DEL,362,3,0,3,0.83
barcode13,5,70942875,A,DEL,363,3,0,3,0.83
barcode13,5,70942876,C,DEL,360,3,0,3,0.83
barcode13,5,70942877,C,DEL,360,3,0,3,0.83
barcode13,5,70942878,T,DEL,361,8,4,4,2.22
barcode13,5,70942881,T,DEL,358,7,0,7,1.96
barcode13,5,70942885,A,DEL,352,20,2,18,5.68
barcode13,5,70942886,A,DEL,352,2,0,2,0.57
barcode13,5,70942888,G,DEL,350,2,0,2,0.57
barcode13,5,70942889,T,DEL,349,10,3,7,2.87
barcode13,5,70942890,T,DEL,349,2,1,1,0.57
barcode13,5,70942893,C,DEL,349,5,1,4,1.43
barcode13,5,70942894,C,DEL,349,4,0,4,1.15
barcode13,5,70942895,A,DEL,348,21,9,12,6.03
barcode13,5,70942896,G,DEL,347,23,11,12,6.63
barcode13,5,70942897,A,DEL,341,21,1,20,6.16
barcode13,5,70942898,A,DEL,340,3,1,2,0.88
barcode13,5,70942902,A,DEL,339,1,1,0,0.29
barcode13,5,70942904,T,DEL,339,2,2,0,0.59
barcode13,5,70942906,A,DEL,338,51,0,51,15.09
barcode13,5,70942908,T,DEL,336,1,1,0,0.3
barcode13,5,70942909,G,DEL,333,1,1,0,0.3
barcode13,5,70942911,C,DEL,332,7,7,0,2.11
barcode13,5,70942912,G,DEL,332,3,0,3,0.9
barcode13,5,70942914,G,DEL,327,1,0,1,0.31
barcode13,5,70942915,A,DEL,314,2,0,2,0.64
barcode13,5,70942918,T,DEL,312,12,6,6,3.85
barcode13,5,70942920,T,DEL,305,5,0,5,1.64
barcode13,5,70942921,A,DEL,304,6,0,6,1.97
barcode13,5,70942924,C,DEL,303,3,0,3,0.99
barcode13,5,70942925,T,DEL,303,3,0,3,0.99
barcode13,5,70942928,C,DEL,293,1,0,1,0.34
barcode13,5,70942929,T,DEL,292,6,0,6,2.05
barcode13,5,70942931,T,DEL,289,4,4,0,1.38
barcode13,5,70942939,T,DEL,253,3,3,0,1.19
barcode13,5,70942948,C,DEL,122,2,0,2,1.64
barcode13,5,70942949,T,DEL,120,1,0,1,0.83
barcode13,5,70942950,C,DEL,86,1,0,1,1.16
barcode13,5,70944618,A,DEL,358,3,0,3,0.84
barcode13,5,70944621,T,DEL,397,2,1,1,0.5
barcode13,5,70944625,T,DEL,426,1,0,1,0.23
barcode13,5,70944626,A,DEL,443,22,0,22,4.97
barcode13,5,70944628,G,DEL,452,3,0,3,0.66
barcode13,5,70944629,T,DEL,456,2,2,0,0.44
barcode13,5,70944632,A,DEL,461,1,0,1,0.22
barcode13,5,70944633,T,DEL,462,13,1,12,2.81
barcode13,5,70944639,T,DEL,485,17,13,4,3.51
barcode13,5,70944642,G,DEL,488,3,0,3,0.61
barcode13,5,70944643,A,DEL,491,3,0,3,0.61
barcode13,5,70944648,T,DEL,511,6,3,3,1.17
barcode13,5,70944649,T,DEL,518,5,0,5,0.97
barcode13,5,70944650,C,DEL,524,5,0,5,0.95
barcode13,5,70944652,T,DEL,529,6,2,4,1.13
barcode13,5,70944653,T,DEL,529,3,0,3,0.57
barcode13,5,70944661,G,DEL,574,2,2,0,0.35
barcode13,5,70944662,G,DEL,576,2,2,0,0.35
barcode13,5,70944663,T,DEL,580,3,0,3,0.52
barcode13,5,70944665,T,DEL,581,8,0,8,1.38
barcode13,5,70944666,A,DEL,582,7,1,6,1.2
barcode13,5,70944667,A,DEL,583,2,0,2,0.34
barcode13,5,70944668,A,DEL,584,3,0,3,0.51
barcode13,5,70944669,A,DEL,584,4,0,4,0.68
barcode13,5,70944670,T,DEL,594,5,0,5,0.84
barcode13,5,70944671,T,DEL,597,1,0,1,0.17
barcode13,5,70944672,C,DEL,598,1,0,1,0.17
barcode13,5,70944673,A,DEL,603,1,0,1,0.17
barcode13,5,70944676,G,DEL,608,1,1,0,0.16
barcode13,5,70944678,C,DEL,614,12,1,11,1.95
barcode13,5,70944679,C,DEL,619,2,2,0,0.32
barcode13,5,70944680,C,DEL,622,3,3,0,0.48
barcode13,5,70944681,A,DEL,628,5,5,0,0.8
barcode13,5,70944682,C,DEL,631,3,0,3,0.48
barcode13,5,70944683,C,DEL,634,3,0,3,0.47
barcode13,5,70944684,A,DEL,636,3,0,3,0.47
barcode13,5,70944685,C,DEL,637,3,0,3,0.47
barcode13,5,70944686,C,DEL,636,3,0,3,0.47
barcode13,5,70944687,G,DEL,640,3,0,3,0.47
barcode13,5,70944691,C,DEL,648,9,6,3,1.39
barcode13,5,70944692,C,DEL,645,4,1,3,0.62
barcode13,5,70944693,G,DEL,651,5,2,3,0.77
barcode13,5,70944694,C,DEL,656,9,1,8,1.37
barcode13,5,70944695,C,DEL,657,9,1,8,1.37
barcode13,5,70944696,A,DEL,663,9,1,8,1.36
barcode13,5,70944697,C,DEL,666,1,1,0,0.15
barcode13,5,70944700,C,DEL,677,1,1,0,0.15
barcode13,5,70944702,A,DEL,690,1,1,0,0.14
barcode13,5,70944704,C,DEL,685,4,0,4,0.58
barcode13,5,70944705,A,DEL,691,4,0,4,0.58
barcode13,5,70944706,C,DEL,693,71,67,4,10.25
barcode13,5,70944707,C,DEL,700,3,0,3,0.43
barcode13,5,70944712,T,DEL,696,1,0,1,0.14
barcode13,5,70944713,T,DEL,691,1,1,0,0.14
barcode13,5,70944714,A,DEL,693,13,13,0,1.88
barcode13,5,70944715,C,DEL,693,2,2,0,0.29
barcode13,5,70944716,T,DEL,693,1,0,1,0.14
barcode13,5,70944717,A,DEL,693,1,1,0,0.14
barcode13,5,70944718,T,DEL,696,1,1,0,0.14
barcode13,5,70944719,C,DEL,690,1,1,0,0.14
barcode13,5,70944723,C,DEL,697,5,0,5,0.72
barcode13,5,70944724,T,DEL,695,6,0,6,0.86
barcode13,5,70944725,G,DEL,694,1,1,0,0.14
barcode13,5,70944727,C,DEL,688,3,0,3,0.44
barcode13,5,70944728,T,DEL,688,3,1,2,0.44
barcode13,5,70944729,G,DEL,690,2,2,0,0.29
barcode13,5,70944730,C,DEL,687,5,0,5,0.73
barcode13,5,70944731,C,DEL,688,1,1,0,0.15
barcode13,5,70944732,T,DEL,690,1,1,0,0.14
barcode13,5,70944735,A,DEL,696,1,0,1,0.14
barcode13,5,70944736,T,DEL,696,10,2,8,1.44
barcode13,5,70944739,C,DEL,693,1,0,1,0.14
barcode13,5,70944740,C,DEL,694,1,1,0,0.14
barcode13,5,70944741,T,DEL,696,18,9,9,2.59
barcode13,5,70944742,T,DEL,705,4,2,2,0.57
barcode13,5,70944743,C,DEL,700,5,1,4,0.71
barcode13,5,70944744,T,DEL,696,3,0,3,0.43
barcode13,5,70944745,G,DEL,697,1,1,0,0.14
barcode13,5,70944746,G,DEL,692,1,0,1,0.14
barcode13,5,70944747,A,DEL,687,1,0,1,0.15
barcode13,5,70944748,C,DEL,686,3,2,1,0.44
barcode13,5,70944749,C,DEL,687,1,0,1,0.15
barcode13,5,70944751,C,DEL,699,2,2,0,0.29
barcode13,5,70944753,A,DEL,697,2,1,1,0.29
barcode13,5,70944754,G,DEL,697,1,0,1,0.14
barcode13,5,70944755,T,DEL,694,8,0,8,1.15
barcode13,5,70944756,A,DEL,683,6,0,6,0.88
barcode13,5,70944757,A,DEL,682,5,0,5,0.73
barcode13,5,70944758,G,DEL,680,5,0,5,0.74
barcode13,5,70944759,T,DEL,680,23,0,23,3.38
barcode13,5,70944760,A,DEL,672,160,9,151,23.81
barcode13,5,70944761,A,DEL,672,74,1,73,11.01
barcode13,5,70944762,A,DEL,671,65,0,65,9.69
barcode13,5,70944763,A,DEL,670,23,1,22,3.43
barcode13,5,70944764,A,DEL,671,1,1,0,0.15
barcode13,5,70944765,A,DEL,670,1,1,0,0.15
barcode13,5,70944766,G,DEL,671,1,1,0,0.15
barcode13,5,70944767,A,DEL,668,1,0,1,0.15
barcode13,5,70944768,G,DEL,668,2,0,2,0.3
barcode13,5,70944769,T,DEL,669,22,0,22,3.29
barcode13,5,70944770,A,DEL,663,2,0,2,0.3
barcode13,5,70944771,T,DEL,664,3,0,3,0.45
barcode13,5,70944772,A,DEL,663,1,0,1,0.15
barcode13,5,70944773,G,DEL,663,1,0,1,0.15
barcode13,5,70944774,G,DEL,662,1,0,1,0.15
barcode13,5,70944775,T,DEL,661,2,1,1,0.3
barcode13,5,70944777,A,DEL,650,2,0,2,0.31
barcode13,5,70944778,G,DEL,646,9,5,4,1.39
barcode13,5,70944779,A,DEL,643,1,0,1,0.16
barcode13,5,70944780,T,DEL,643,24,7,17,3.73
barcode13,5,70944783,T,DEL,637,1,1,0,0.16
barcode13,5,70944784,G,DEL,634,1,1,0,0.16
barcode13,5,70944786,T,DEL,630,6,2,4,0.95
barcode13,5,70944789,C,DEL,618,3,2,1,0.49
barcode13,5,70944790,A,DEL,617,1,0,1,0.16
barcode13,5,70944798,T,DEL,577,5,4,1,0.87
barcode13,5,70944800,T,DEL,567,1,0,1,0.18
barcode13,5,70944801,G,DEL,565,1,0,1,0.18
barcode13,5,70944802,A,DEL,556,1,0,1,0.18
barcode13,5,70944806,T,DEL,532,1,1,0,0.19
barcode13,5,70944813,A,DEL,496,6,6,0,1.21
barcode13,5,70944816,A,DEL,458,11,7,4,2.4
barcode13,5,70944817,G,DEL,452,7,3,4,1.55
barcode13,5,70944819,G,DEL,441,11,11,0,2.49
barcode13,5,70944820,G,DEL,428,5,5,0,1.17
barcode13,5,70944821,A,DEL,426,5,5,0,1.17
barcode13,5,70944822,T,DEL,426,4,3,1,0.94
barcode13,5,70944823,T,DEL,421,1,1,0,0.24
barcode13,5,70944824,G,DEL,417,3,3,0,0.72
barcode13,5,70944825,T,DEL,404,6,0,6,1.49
barcode13,5,70944826,A,DEL,390,19,12,7,4.87
barcode13,5,70945984,C,DEL,497,12,0,12,2.41
barcode13,5,70945990,T,DEL,591,7,7,0,1.18
barcode13,5,70945994,C,DEL,634,1,1,0,0.16
barcode13,5,70945995,T,DEL,634,4,4,0,0.63
barcode13,5,70945996,A,DEL,638,4,4,0,0.63
barcode13,5,70945997,T,DEL,644,3,0,3,0.47
barcode13,5,70946000,A,DEL,663,4,0,4,0.6
barcode13,5,70946004,T,DEL,685,1,0,1,0.15
barcode13,5,70946005,A,DEL,688,12,1,11,1.74
barcode13,5,70946006,A,DEL,691,1,0,1,0.14
barcode13,5,70946009,C,DEL,699,1,0,1,0.14
barcode13,5,70946011,C,DEL,714,2,0,2,0.28
barcode13,5,70946012,C,DEL,716,7,0,7,0.98
barcode13,5,70946013,A,DEL,717,17,0,17,2.37
barcode13,5,70946014,G,DEL,720,25,8,17,3.47
barcode13,5,70946015,A,DEL,729,1,1,0,0.14
barcode13,5,70946016,C,DEL,733,3,1,2,0.41
barcode13,5,70946017,T,DEL,736,8,8,0,1.09
barcode13,5,70946018,T,DEL,737,2,2,0,0.27
barcode13,5,70946019,T,DEL,739,4,4,0,0.54
barcode13,5,70946020,A,DEL,746,6,6,0,0.8
barcode13,5,70946021,C,DEL,747,2,2,0,0.27
barcode13,5,70946022,T,DEL,748,73,29,44,9.76
barcode13,5,70946023,T,DEL,750,9,6,3,1.2
barcode13,5,70946024,T,DEL,754,6,6,0,0.8
barcode13,5,70946025,T,DEL,757,2,2,0,0.26
barcode13,5,70946026,T,DEL,760,2,2,0,0.26
barcode13,5,70946027,T,DEL,760,3,3,0,0.39
barcode13,5,70946028,G,DEL,792,4,4,0,0.51
barcode13,5,70946029,T,DEL,805,10,6,4,1.24
barcode13,5,70946030,T,DEL,824,1,1,0,0.12
barcode13,5,70946031,T,DEL,827,1,1,0,0.12
barcode13,5,70946032,A,DEL,879,4,4,0,0.46
barcode13,5,70946033,C,DEL,881,21,2,19,2.38
barcode13,5,70946034,T,DEL,884,1,1,0,0.11
barcode13,5,70946035,G,DEL,889,2,1,1,0.22
barcode13,5,70946036,G,DEL,891,1,1,0,0.11
barcode13,5,70946037,A,DEL,898,13,1,12,1.45
barcode13,5,70946038,T,DEL,900,12,1,11,1.33
barcode13,5,70946039,A,DEL,906,1,1,0,0.11
barcode13,5,70946040,T,DEL,906,2,1,1,0.22
barcode13,5,70946041,A,DEL,910,57,4,53,6.26
barcode13,5,70946042,A,DEL,914,5,4,1,0.55
barcode13,5,70946043,A,DEL,914,4,4,0,0.44
barcode13,5,70946044,C,DEL,917,2,1,1,0.22
barcode13,5,70946045,A,DEL,916,11,1,10,1.2
barcode13,5,70946046,A,DEL,916,11,10,1,1.2
barcode13,5,70946047,T,DEL,916,10,9,1,1.09
barcode13,5,70946048,A,DEL,944,2,0,2,0.21
barcode13,5,70946049,T,DEL,944,5,2,3,0.53
barcode13,5,70946050,C,DEL,948,10,3,7,1.05
barcode13,5,70946051,T,DEL,951,168,133,35,17.67
barcode13,5,70946052,T,DEL,959,40,32,8,4.17
barcode13,5,70946053,T,DEL,967,11,7,4,1.14
barcode13,5,70946054,T,DEL,973,7,6,1,0.72
barcode13,5,70946055,T,DEL,974,13,7,6,1.33
barcode13,5,70946056,C,DEL,988,15,8,7,1.52
barcode13,5,70946057,T,DEL,989,7,1,6,0.71
barcode13,5,70946058,G,DEL,996,1,1,0,0.1
barcode13,5,70946059,T,DEL,997,1,0,1,0.1
barcode13,5,70946060,C,DEL,998,27,0,27,2.71
barcode13,5,70946061,T,DEL,1012,1,0,1,0.1
barcode13,5,70946062,C,DEL,1017,15,14,1,1.47
barcode13,5,70946063,C,DEL,1025,2,0,2,0.2
barcode13,5,70946064,A,DEL,1029,5,2,3,0.49
barcode13,5,70946065,G,DEL,1029,9,4,5,0.87
barcode13,5,70946066,A,DEL,1033,30,1,29,2.9
barcode13,5,70946067,T,DEL,1033,32,1,31,3.1
barcode13,5,70946068,A,DEL,1046,7,1,6,0.67
barcode13,5,70946069,A,DEL,1045,6,0,6,0.57
barcode13,5,70946070,T,DEL,1052,10,0,10,0.95
barcode13,5,70946071,T,DEL,1053,9,1,8,0.85
barcode13,5,70946072,C,DEL,1057,244,73,171,23.08
barcode13,5,70946073,C,DEL,1061,37,22,15,3.49
barcode13,5,70946074,C,DEL,1067,5,5,0,0.47
barcode13,5,70946075,C,DEL,1070,2,0,2,0.19
barcode13,5,70946076,C,DEL,1070,3,1,2,0.28
barcode13,5,70946077,A,DEL,1072,5,2,3,0.47
barcode13,5,70946078,C,DEL,1072,1,0,1,0.09
barcode13,5,70946081,C,DEL,1083,3,0,3,0.28
barcode13,5,70946082,C,DEL,1088,1,0,1,0.09
barcode13,5,70946083,T,DEL,1092,1,1,0,0.09
barcode13,5,70946084,C,DEL,1097,180,180,0,16.41
barcode13,5,70946085,C,DEL,1101,1,1,0,0.09
barcode13,5,70946086,C,DEL,1100,1,1,0,0.09
barcode13,5,70946087,A,DEL,1095,23,3,20,2.1
barcode13,5,70946088,T,DEL,1094,21,1,20,1.92
barcode13,5,70946090,T,DEL,1089,3,3,0,0.28
barcode13,5,70946091,G,DEL,1090,4,3,1,0.37
barcode13,5,70946092,T,DEL,1102,1,1,0,0.09
barcode13,5,70946093,C,DEL,1101,12,11,1,1.09
barcode13,5,70946096,G,DEL,1109,5,0,5,0.45
barcode13,5,70946097,A,DEL,1108,7,4,3,0.63
barcode13,5,70946098,T,DEL,1113,6,1,5,0.54
barcode13,5,70946099,T,DEL,1110,157,9,148,14.14
barcode13,5,70946100,C,DEL,1114,166,11,155,14.9
barcode13,5,70946101,T,DEL,1120,6,0,6,0.54
barcode13,5,70946102,C,DEL,1115,8,2,6,0.72
barcode13,5,70946103,T,DEL,1133,41,15,26,3.62
barcode13,5,70946104,T,DEL,1136,22,1,21,1.94
barcode13,5,70946105,G,DEL,1135,24,1,23,2.11
barcode13,5,70946106,A,DEL,1144,1,1,0,0.09
barcode13,5,70946108,G,DEL,1141,1,0,1,0.09
barcode13,5,70946110,T,DEL,1140,2,1,1,0.18
barcode13,5,70946111,G,DEL,1144,2,1,1,0.17
barcode13,5,70946112,C,DEL,1153,2,1,1,0.17
barcode13,5,70946113,T,DEL,1161,1,0,1,0.09
barcode13,5,70946114,G,DEL,1162,4,1,3,0.34
barcode13,5,70946118,C,DEL,1155,12,1,11,1.04
barcode13,5,70946119,T,DEL,1160,5,4,1,0.43
barcode13,5,70946120,T,DEL,1175,2,2,0,0.17
barcode13,5,70946122,G,DEL,1182,78,2,76,6.6
barcode13,5,70946123,G,DEL,1182,2,0,2,0.17
barcode13,5,70946124,G,DEL,1188,3,0,3,0.25
barcode13,5,70946125,A,DEL,1194,14,1,13,1.17
barcode13,5,70946126,A,DEL,1200,1,0,1,0.08
barcode13,5,70946127,G,DEL,1200,11,6,5,0.92
barcode13,5,70946128,T,DEL,1193,27,3,24,2.26
barcode13,5,70946129,A,DEL,1232,3,3,0,0.24
barcode13,5,70946132,T,DEL,1237,148,148,0,11.96
barcode13,5,70946134,A,DEL,1229,6,0,6,0.49
barcode13,5,70946135,A,DEL,1231,2,1,1,0.16
barcode13,5,70946136,T,DEL,1237,13,5,8,1.05
barcode13,5,70946141,T,DEL,1279,3,3,0,0.23
barcode13,5,70946142,G,DEL,1251,2,1,1,0.16
barcode13,5,70946143,G,DEL,1257,4,0,4,0.32
barcode13,5,70946144,T,DEL,1258,11,0,11,0.87
barcode13,5,70946145,A,DEL,1243,2,0,2,0.16
barcode13,5,70946146,C,DEL,1249,1,0,1,0.08
barcode13,5,70946147,A,DEL,1258,1,0,1,0.08
barcode13,5,70946150,A,DEL,1289,2,2,0,0.16
barcode13,5,70946151,G,DEL,1285,3,3,0,0.23
barcode13,5,70946152,T,DEL,1287,1,1,0,0.08
barcode13,5,70946155,C,DEL,1295,1,1,0,0.08
barcode13,5,70946157,A,DEL,1283,4,3,1,0.31
barcode13,5,70946158,T,DEL,1283,2,1,1,0.16
barcode13,5,70946159,C,DEL,1251,1,0,1,0.08
barcode13,5,70946161,T,DEL,1252,3,2,1,0.24
barcode13,5,70946162,A,DEL,1361,1,0,1,0.07
barcode13,5,70946163,C,DEL,1361,7,1,6,0.51
barcode13,5,70946164,T,DEL,1368,6,0,6,0.44
barcode13,5,70946168,T,DEL,1366,2,2,0,0.15
barcode13,5,70946169,A,DEL,1344,3,3,0,0.22
barcode13,5,70946170,T,DEL,1341,9,9,0,0.67
barcode13,5,70946171,T,DEL,1343,40,40,0,2.98
barcode13,5,70946172,A,DEL,1358,40,40,0,2.95
barcode13,5,70946173,T,DEL,1361,9,8,1,0.66
barcode13,5,70946174,A,DEL,1389,11,11,0,0.79
barcode13,5,70946176,G,DEL,1392,1,0,1,0.07
barcode13,5,70946177,G,DEL,1412,12,1,11,0.85
barcode13,5,70946178,T,DEL,1409,22,2,20,1.56
barcode13,5,70946179,A,DEL,1382,7,0,7,0.51
barcode13,5,70946180,A,DEL,1379,10,0,10,0.73
barcode13,5,70946181,G,DEL,1376,9,0,9,0.65
barcode13,5,70946182,T,DEL,1377,16,0,16,1.16
barcode13,5,70946183,A,DEL,1360,27,0,27,1.99
barcode13,5,70946189,T,DEL,1402,1,1,0,0.07
barcode13,5,70946190,C,DEL,1414,46,1,45,3.25
barcode13,5,70946191,A,DEL,1420,3,1,2,0.21
barcode13,5,70946192,G,DEL,1417,8,4,4,0.56
barcode13,5,70946193,C,DEL,1416,4,1,3,0.28
barcode13,5,70946194,A,DEL,1425,2,1,1,0.14
barcode13,5,70946196,C,DEL,1423,4,2,2,0.28
barcode13,5,70946197,T,DEL,1428,336,303,33,23.53
barcode13,5,70946198,T,DEL,1432,21,21,0,1.47
barcode13,5,70946199,T,DEL,1431,2,1,1,0.14
barcode13,5,70946200,T,DEL,1431,2,0,2,0.14
barcode13,5,70946201,C,DEL,1431,3,0,3,0.21
barcode13,5,70946203,T,DEL,1435,1,1,0,0.07
barcode13,5,70946204,G,DEL,1434,21,0,21,1.46
barcode13,5,70946209,T,DEL,1431,63,51,12,4.4
barcode13,5,70946210,T,DEL,1430,5,0,5,0.35
barcode13,5,70946211,T,DEL,1433,5,0,5,0.35
barcode13,5,70946212,T,DEL,1436,3,0,3,0.21
barcode13,5,70946215,T,DEL,1457,2,2,0,0.14
barcode13,5,70946216,G,DEL,1480,4,4,0,0.27
barcode13,5,70946217,T,DEL,1482,1,1,0,0.07
barcode13,5,70946218,A,DEL,1487,1,1,0,0.07
barcode13,5,70946220,T,DEL,1487,2,2,0,0.13
barcode13,5,70946223,T,DEL,1484,2,2,0,0.13
barcode13,5,70946224,G,DEL,1494,2,2,0,0.13
barcode13,5,70946225,T,DEL,1491,4,4,0,0.27
barcode13,5,70946228,C,DEL,1481,2,0,2,0.14
barcode13,5,70946229,T,DEL,1486,31,31,0,2.09
barcode13,5,70946230,T,DEL,1471,2,2,0,0.14
barcode13,5,70946231,T,DEL,1469,2,2,0,0.14
barcode13,5,70946232,G,DEL,1471,2,2,0,0.14
barcode13,5,70946233,T,DEL,1470,48,38,10,3.27
barcode13,5,70946234,T,DEL,1469,3,3,0,0.2
barcode13,5,70946235,T,DEL,1463,1,1,0,0.07
barcode13,5,70946236,T,DEL,1462,1,1,0,0.07
barcode13,5,70946237,G,DEL,1460,1,1,0,0.07
barcode13,5,70946238,T,DEL,1460,1,0,1,0.07
barcode13,5,70946239,A,DEL,1450,17,15,2,1.17
barcode13,5,70946241,A,DEL,1446,4,3,1,0.28
barcode13,5,70946242,T,DEL,1445,25,4,21,1.73
barcode13,5,70946243,T,DEL,1440,1,1,0,0.07
barcode13,5,70946244,T,DEL,1435,9,8,1,0.63
barcode13,5,70946245,A,DEL,1420,18,17,1,1.27
barcode13,5,70946246,T,DEL,1420,3,1,2,0.21
barcode13,5,70946247,A,DEL,1411,50,29,21,3.54
barcode13,5,70946248,A,DEL,1411,2,1,1,0.14
barcode13,5,70946249,A,DEL,1411,1,1,0,0.07
barcode13,5,70946250,A,DEL,1410,1,1,0,0.07
barcode13,5,70946251,T,DEL,1407,2,2,0,0.14
barcode13,5,70946252,A,DEL,1398,1,1,0,0.07
barcode13,5,70946253,C,DEL,1395,5,5,0,0.36
barcode13,5,70946255,A,DEL,1393,9,9,0,0.65
barcode13,5,70946256,C,DEL,1391,5,5,0,0.36
barcode13,5,70946257,T,DEL,1390,4,3,1,0.29
barcode13,5,70946259,G,DEL,1381,2,2,0,0.14
barcode13,5,70946260,C,DEL,1377,9,7,2,0.65
barcode13,5,70946261,T,DEL,1376,25,22,3,1.82
barcode13,5,70946262,T,DEL,1372,25,19,6,1.82
barcode13,5,70946263,C,DEL,1365,29,21,8,2.12
barcode13,5,70946264,T,DEL,1364,3,1,2,0.22
barcode13,5,70946265,C,DEL,1357,7,5,2,0.52
barcode13,5,70946266,T,DEL,1355,15,6,9,1.11
barcode13,5,70946267,C,DEL,1337,16,11,5,1.2
barcode13,5,70946268,T,DEL,1329,137,130,7,10.31
barcode13,5,70946269,T,DEL,1322,8,1,7,0.61
barcode13,5,70946270,T,DEL,1317,8,1,7,0.61
barcode13,5,70946271,A,DEL,1304,5,3,2,0.38
barcode13,5,70946272,T,DEL,1304,6,5,1,0.46
barcode13,5,70946273,A,DEL,1282,12,12,0,0.94
barcode13,5,70946274,T,DEL,1280,8,8,0,0.62
barcode13,5,70946275,T,DEL,1278,10,10,0,0.78
barcode13,5,70946276,A,DEL,1268,32,32,0,2.52
barcode13,5,70946277,C,DEL,1267,12,12,0,0.95
barcode13,5,70946278,T,DEL,1266,2,1,1,0.16
barcode13,5,70946279,A,DEL,1251,25,15,10,2.0
barcode13,5,70946280,A,DEL,1248,2,0,2,0.16
barcode13,5,70946281,A,DEL,1242,1,0,1,0.08
barcode13,5,70946285,T,DEL,1225,1,1,0,0.08
barcode13,5,70946286,A,DEL,1211,48,47,1,3.96
barcode13,5,70946287,A,DEL,1209,3,2,1,0.25
barcode13,5,70946288,A,DEL,1209,2,2,0,0.17
barcode13,5,70946289,A,DEL,1205,2,2,0,0.17
barcode13,5,70946290,A,DEL,1197,3,3,0,0.25
barcode13,5,70946291,T,DEL,1197,3,3,0,0.25
barcode13,5,70946292,A,DEL,1177,179,169,10,15.21
barcode13,5,70946293,A,DEL,1174,56,56,0,4.77
barcode13,5,70946294,A,DEL,1168,14,14,0,1.2
barcode13,5,70946295,A,DEL,1160,1,1,0,0.09
barcode13,5,70946299,T,DEL,1131,4,4,0,0.35
barcode13,5,70946300,A,DEL,1119,1,1,0,0.09
barcode13,5,70946301,C,DEL,1114,2,2,0,0.18
barcode13,5,70946302,A,DEL,1094,3,2,1,0.27
barcode13,5,70946303,A,DEL,1084,1,0,1,0.09
barcode13,5,70946305,T,DEL,1078,5,4,1,0.46
barcode13,5,70946306,G,DEL,1063,4,4,0,0.38
barcode13,5,70946307,T,DEL,1056,2,2,0,0.19
barcode13,5,70946308,C,DEL,911,3,2,1,0.33
barcode13,5,70946315,T,DEL,692,2,2,0,0.29
barcode13,5,70951939,A,DEL,837,1,1,0,0.12
barcode13,5,70951943,T,DEL,859,27,2,25,3.14
barcode13,5,70951946,C,DEL,938,2,0,2,0.21
barcode13,5,70951947,A,DEL,942,6,1,5,0.64
barcode13,5,70951948,G,DEL,942,14,0,14,1.49
barcode13,5,70951949,A,DEL,955,5,0,5,0.52
barcode13,5,70951950,C,DEL,958,5,0,5,0.52
barcode13,5,70951951,A,DEL,958,154,10,144,16.08
barcode13,5,70951952,A,DEL,966,1,0,1,0.1
barcode13,5,70951956,C,DEL,977,2,0,2,0.2
barcode13,5,70951957,A,DEL,979,178,38,140,18.18
barcode13,5,70951958,A,DEL,985,31,3,28,3.15
barcode13,5,70951959,A,DEL,998,3,1,2,0.3
barcode13,5,70951960,A,DEL,1000,3,2,1,0.3
barcode13,5,70951961,A,DEL,1004,5,4,1,0.5
barcode13,5,70951962,G,DEL,1006,6,5,1,0.6
barcode13,5,70951963,A,DEL,1010,50,0,50,4.95
barcode13,5,70951967,A,DEL,1046,60,1,59,5.74
barcode13,5,70951968,A,DEL,1048,1,1,0,0.1
barcode13,5,70951969,G,DEL,1049,1,1,0,0.1
barcode13,5,70951971,T,DEL,1055,2,1,1,0.19
barcode13,5,70951973,C,DEL,1073,12,0,12,1.12
barcode13,5,70951975,C,DEL,1097,13,0,13,1.19
barcode13,5,70951976,A,DEL,1098,4,0,4,0.36
barcode13,5,70951977,C,DEL,1109,2,1,1,0.18
barcode13,5,70951978,A,DEL,1109,3,0,3,0.27
barcode13,5,70951979,T,DEL,1122,7,5,2,0.62
barcode13,5,70951980,T,DEL,1125,1,0,1,0.09
barcode13,5,70951981,C,DEL,1138,2,0,2,0.18
barcode13,5,70951982,C,DEL,1147,1,0,1,0.09
barcode13,5,70951983,T,DEL,1157,26,13,13,2.25
barcode13,5,70951984,T,DEL,1160,12,2,10,1.03
barcode13,5,70951985,A,DEL,1165,28,21,7,2.4
barcode13,5,70951986,A,DEL,1169,2,1,1,0.17
barcode13,5,70951987,A,DEL,1177,2,1,1,0.17
barcode13,5,70951988,T,DEL,1180,3,2,1,0.25
barcode13,5,70951989,T,DEL,1183,3,1,2,0.25
barcode13,5,70951990,A,DEL,1202,17,0,17,1.41
barcode13,5,70951993,G,DEL,1233,6,5,1,0.49
barcode13,5,70951994,A,DEL,1250,12,10,2,0.96
barcode13,5,70951995,G,DEL,1252,19,6,13,1.52
barcode13,5,70951996,T,DEL,1260,5,0,5,0.4
barcode13,5,70951997,A,DEL,1271,4,1,3,0.31
barcode13,5,70951998,A,DEL,1280,3,0,3,0.23
barcode13,5,70952000,T,DEL,1287,2,2,0,0.16
barcode13,5,70952001,C,DEL,1298,9,2,7,0.69
barcode13,5,70952002,T,DEL,1325,9,1,8,0.68
barcode13,5,70952003,G,DEL,1403,6,1,5,0.43
barcode13,5,70952004,C,DEL,1445,26,19,7,1.8
barcode13,5,70952005,C,DEL,1452,7,0,7,0.48
barcode13,5,70952006,A,DEL,1477,1,1,0,0.07
barcode13,5,70952007,G,DEL,1484,5,0,5,0.34
barcode13,5,70952008,C,DEL,1479,2,0,2,0.14
barcode13,5,70952009,A,DEL,1479,1,1,0,0.07
barcode13,5,70952010,T,DEL,1479,8,7,1,0.54
barcode13,5,70952011,T,DEL,1480,7,7,0,0.47
barcode13,5,70952012,A,DEL,1490,7,7,0,0.47
barcode13,5,70952014,G,DEL,1494,3,0,3,0.2
barcode13,5,70952015,A,DEL,1516,195,39,156,12.86
barcode13,5,70952020,G,DEL,1531,2,1,1,0.13
barcode13,5,70952021,A,DEL,1536,1,0,1,0.07
barcode13,5,70952022,A,DEL,1539,2,0,2,0.13
barcode13,5,70952023,T,DEL,1529,6,2,4,0.39
barcode13,5,70952024,C,DEL,1534,3,2,1,0.2
barcode13,5,70952025,T,DEL,1536,12,11,1,0.78
barcode13,5,70952027,A,DEL,1560,2,2,0,0.13
barcode13,5,70952028,C,DEL,1561,3,3,0,0.19
barcode13,5,70952029,T,DEL,1567,102,16,86,6.51
barcode13,5,70952030,T,DEL,1574,1,1,0,0.06
barcode13,5,70952031,T,DEL,1577,5,5,0,0.32
barcode13,5,70952032,T,DEL,1564,7,7,0,0.45
barcode13,5,70952033,G,DEL,1577,11,11,0,0.7
barcode13,5,70952034,T,DEL,1572,33,0,33,2.1
barcode13,5,70952035,A,DEL,1561,20,6,14,1.28
barcode13,5,70952036,A,DEL,1560,6,0,6,0.38
barcode13,5,70952039,C,DEL,1548,3,3,0,0.19
barcode13,5,70952040,T,DEL,1551,6,5,1,0.39
barcode13,5,70952046,G,DEL,1583,2,0,2,0.13
barcode13,5,70952047,T,DEL,1595,7,0,7,0.44
barcode13,5,70952048,T,DEL,1605,1,0,1,0.06
barcode13,5,70952049,T,DEL,1603,3,0,3,0.19
barcode13,5,70952050,G,DEL,1756,3,1,2,0.17
barcode13,5,70952052,G,DEL,1781,25,23,2,1.4
barcode13,5,70952053,G,DEL,1799,1,0,1,0.06
barcode13,5,70952054,A,DEL,1798,14,4,10,0.78
barcode13,5,70952055,A,DEL,1769,1,0,1,0.06
barcode13,5,70952056,A,DEL,1759,1,0,1,0.06
barcode13,5,70952057,A,DEL,1758,1,0,1,0.06
barcode13,5,70952058,C,DEL,1763,2,0,2,0.11
barcode13,5,70952059,A,DEL,1762,91,0,91,5.16
barcode13,5,70952062,T,DEL,1773,1,1,0,0.06
barcode13,5,70952063,G,DEL,1769,2,1,1,0.11
barcode13,5,70952064,T,DEL,1766,76,34,42,4.3
barcode13,5,70952065,T,DEL,1770,2,0,2,0.11
barcode13,5,70952068,T,DEL,1791,2,0,2,0.11
barcode13,5,70952069,G,DEL,1796,11,1,10,0.61
barcode13,5,70952070,A,DEL,1834,10,0,10,0.55
barcode13,5,70952071,A,DEL,1845,3,1,2,0.16
barcode13,5,70952072,C,DEL,1858,8,6,2,0.43
barcode13,5,70952073,A,DEL,1859,2,1,1,0.11
barcode13,5,70952074,T,DEL,1859,20,8,12,1.08
barcode13,5,70952076,T,DEL,1865,1,0,1,0.05
barcode13,5,70952077,A,DEL,1875,158,5,153,8.43
barcode13,5,70952078,A,DEL,1878,30,0,30,1.6
barcode13,5,70952081,A,DEL,1874,2,0,2,0.11
barcode13,5,70952082,G,DEL,1874,3,0,3,0.16
barcode13,5,70952083,T,DEL,1889,68,68,0,3.6
barcode13,5,70952084,T,DEL,1901,12,12,0,0.63
barcode13,5,70952085,C,DEL,1905,43,35,8,2.26
barcode13,5,70952086,A,DEL,1908,59,6,53,3.09
barcode13,5,70952087,G,DEL,1909,61,6,55,3.2
barcode13,5,70952088,A,DEL,1907,4,3,1,0.21
barcode13,5,70952089,T,DEL,1908,1,0,1,0.05
barcode13,5,70952090,G,DEL,1925,1,1,0,0.05
barcode13,5,70952091,T,DEL,1921,31,31,0,1.61
barcode13,5,70952093,A,DEL,1936,53,3,50,2.74
barcode13,5,70952094,A,DEL,1939,5,0,5,0.26
barcode13,5,70952098,G,DEL,1935,2,2,0,0.1
barcode13,5,70952099,T,DEL,1937,19,19,0,0.98
barcode13,5,70952101,G,DEL,1932,4,2,2,0.21
barcode13,5,70952102,A,DEL,1958,126,2,124,6.44
barcode13,5,70952105,G,DEL,1957,1,0,1,0.05
barcode13,5,70952107,T,DEL,1968,18,18,0,0.91
barcode13,5,70952109,A,DEL,1958,6,0,6,0.31
barcode13,5,70952111,T,DEL,1955,3,1,2,0.15
barcode13,5,70952112,G,DEL,1962,2,1,1,0.1
barcode13,5,70952113,T,DEL,1948,40,0,40,2.05
barcode13,5,70952114,A,DEL,1933,16,4,12,0.83
barcode13,5,70952115,A,DEL,1928,2,0,2,0.1
barcode13,5,70952116,A,DEL,1944,1,0,1,0.05
barcode13,5,70952117,A,DEL,1930,1,0,1,0.05
barcode13,5,70952118,C,DEL,1930,2,0,2,0.1
barcode13,5,70952122,C,DEL,1809,1,1,0,0.06
barcode13,5,70952123,A,DEL,1801,4,1,3,0.22
barcode13,5,70952124,A,DEL,1800,1,1,0,0.06
barcode13,5,70952125,T,DEL,1797,1,1,0,0.06
barcode13,5,70952126,A,DEL,1766,6,6,0,0.34
barcode13,5,70952127,T,DEL,1766,24,24,0,1.36
barcode13,5,70952129,A,DEL,1766,9,0,9,0.51
barcode13,5,70952132,G,DEL,1747,9,9,0,0.52
barcode13,5,70952133,A,DEL,1743,11,9,2,0.63
barcode13,5,70952134,A,DEL,1742,3,3,0,0.17
barcode13,5,70952135,T,DEL,1730,199,124,75,11.5
barcode13,5,70952139,G,DEL,1714,1,0,1,0.06
barcode13,5,70952141,T,DEL,1713,1,1,0,0.06
barcode13,5,70952142,G,DEL,1708,2,1,1,0.12
barcode13,5,70952143,C,DEL,1703,37,35,2,2.17
barcode13,5,70952144,C,DEL,1689,3,1,2,0.18
barcode13,5,70952145,A,DEL,1667,13,3,10,0.78
barcode13,5,70952146,A,DEL,1664,1,0,1,0.06
barcode13,5,70952150,T,DEL,1634,2,1,1,0.12
barcode13,5,70952151,A,DEL,1617,2,2,0,0.12
barcode13,5,70952152,T,DEL,1616,6,6,0,0.37
barcode13,5,70952154,A,DEL,1564,7,2,5,0.45
barcode13,5,70952155,G,DEL,1556,13,3,10,0.84
barcode13,5,70952158,A,DEL,1531,35,26,9,2.29
barcode13,5,70952159,A,DEL,1530,2,0,2,0.13
barcode13,5,70952164,T,DEL,1496,11,11,0,0.74
barcode13,5,70952165,T,DEL,1480,1,1,0,0.07
barcode13,5,70952166,A,DEL,1447,1,0,1,0.07
barcode13,5,70952169,C,DEL,1382,4,0,4,0.29
barcode13,5,70952170,T,DEL,1377,16,2,14,1.16
barcode13,5,70952171,A,DEL,1353,3,2,1,0.22
barcode13,5,70952173,A,DEL,1307,3,0,3,0.23
barcode13,5,70952174,T,DEL,1304,11,1,10,0.84
barcode13,5,70952175,C,DEL,1287,25,22,3,1.94
barcode13,5,70952176,C,DEL,1282,1,1,0,0.08
barcode13,5,70952177,C,DEL,1274,3,3,0,0.24
barcode13,5,70952178,T,DEL,1252,18,3,15,1.44
barcode13,5,70952179,A,DEL,1214,11,11,0,0.91
barcode13,5,70952180,C,DEL,1191,2,0,2,0.17
barcode13,5,70952181,T,DEL,1181,2,0,2,0.17
barcode13,5,70952182,A,DEL,1135,7,7,0,0.62
barcode13,5,70952183,G,DEL,1129,2,2,0,0.18
barcode13,5,70952184,A,DEL,1126,2,0,2,0.18
barcode13,5,70952186,T,DEL,1113,3,2,1,0.27
barcode13,5,70952187,T,DEL,1103,1,1,0,0.09
barcode13,5,70952188,C,DEL,1087,3,2,1,0.28
barcode13,5,70952189,T,DEL,1071,1,0,1,0.09
barcode13,5,70952190,C,DEL,1049,7,0,7,0.67
barcode13,5,70952191,A,DEL,1044,2,0,2,0.19
barcode13,5,70952192,T,DEL,1037,1,0,1,0.1
barcode13,5,70952193,A,DEL,1002,1,0,1,0.1
barcode13,5,70952194,C,DEL,939,1,1,0,0.11
barcode13,5,70952195,T,DEL,921,5,3,2,0.54
barcode13,5,70952197,A,DEL,829,1,0,1,0.12
barcode13,5,70952200,T,DEL,825,1,1,0,0.12
barcode13,5,70952201,G,DEL,788,1,1,0,0.13
barcode13,5,70952202,G,DEL,783,1,1,0,0.13
barcode13,5,70952203,T,DEL,777,4,4,0,0.51
barcode08,5,70924860,A,DEL,230,13,0,13,5.65
barcode08,5,70924864,C,DEL,388,1,0,1,0.26
barcode08,5,70924865,A,DEL,407,4,0,4,0.98
barcode08,5,70924868,C,DEL,427,4,0,4,0.94
barcode08,5,70924869,A,DEL,437,8,0,8,1.83
barcode08,5,70924870,A,DEL,440,2,0,2,0.45
barcode08,5,70924871,A,DEL,440,8,2,6,1.82
barcode08,5,70924872,C,DEL,441,22,2,20,4.99
barcode08,5,70924873,A,DEL,442,103,11,92,23.3
barcode08,5,70924874,A,DEL,443,57,1,56,12.87
barcode08,5,70924875,A,DEL,447,26,0,26,5.82
barcode08,5,70924876,A,DEL,448,2,0,2,0.45
barcode08,5,70924877,A,DEL,449,2,0,2,0.45
barcode08,5,70924878,A,DEL,451,2,0,2,0.44
barcode08,5,70924881,A,DEL,461,1,1,0,0.22
barcode08,5,70924882,A,DEL,463,2,1,1,0.43
barcode08,5,70924883,G,DEL,463,4,2,2,0.86
barcode08,5,70924885,A,DEL,480,18,0,18,3.75
barcode08,5,70924890,A,DEL,492,3,0,3,0.61
barcode08,5,70924891,A,DEL,493,1,0,1,0.2
barcode08,5,70924892,A,DEL,496,2,1,1,0.4
barcode08,5,70924893,T,DEL,496,2,1,1,0.4
barcode08,5,70924894,A,DEL,502,1,0,1,0.2
barcode08,5,70924895,T,DEL,504,1,0,1,0.2
barcode08,5,70924896,A,DEL,517,3,0,3,0.58
barcode08,5,70924898,C,DEL,548,1,0,1,0.18
barcode08,5,70924902,G,DEL,641,1,0,1,0.16
barcode08,5,70924905,A,DEL,651,17,0,17,2.61
barcode08,5,70924909,G,DEL,663,1,0,1,0.15
barcode08,5,70924910,A,DEL,677,10,0,10,1.48
barcode08,5,70924911,A,DEL,678,1,0,1,0.15
barcode08,5,70924913,G,DEL,681,1,1,0,0.15
barcode08,5,70924916,T,DEL,691,9,8,1,1.3
barcode08,5,70924917,T,DEL,694,1,0,1,0.14
barcode08,5,70924918,G,DEL,705,9,6,3,1.28
barcode08,5,70924919,A,DEL,725,9,5,4,1.24
barcode08,5,70924920,G,DEL,734,2,1,1,0.27
barcode08,5,70924921,A,DEL,742,1,1,0,0.13
barcode08,5,70924922,G,DEL,744,5,1,4,0.67
barcode08,5,70924923,A,DEL,749,3,2,1,0.4
barcode08,5,70924924,A,DEL,752,2,2,0,0.27
barcode08,5,70924927,G,DEL,752,4,1,3,0.53
barcode08,5,70924928,A,DEL,753,61,14,47,8.1
barcode08,5,70924929,A,DEL,755,4,2,2,0.53
barcode08,5,70924930,A,DEL,753,2,2,0,0.27
barcode08,5,70924931,A,DEL,752,4,4,0,0.53
barcode08,5,70924932,A,DEL,754,6,4,2,0.8
barcode08,5,70924933,T,DEL,755,6,4,2,0.79
barcode08,5,70924934,A,DEL,761,2,2,0,0.26
barcode08,5,70924935,T,DEL,763,2,2,0,0.26
barcode08,5,70924936,A,DEL,777,3,1,2,0.39
barcode08,5,70924937,C,DEL,785,3,1,2,0.38
barcode08,5,70924938,A,DEL,794,1,0,1,0.13
barcode08,5,70924939,C,DEL,795,1,0,1,0.13
barcode08,5,70924941,C,DEL,816,1,1,0,0.12
barcode08,5,70924943,A,DEL,818,2,0,2,0.24
barcode08,5,70924944,C,DEL,822,6,1,5,0.73
barcode08,5,70924945,A,DEL,819,9,3,6,1.1
barcode08,5,70924946,A,DEL,826,3,1,2,0.36
barcode08,5,70924947,A,DEL,827,2,1,1,0.24
barcode08,5,70924948,T,DEL,827,2,1,1,0.24
barcode08,5,70924949,G,DEL,833,2,1,1,0.24
barcode08,5,70924950,T,DEL,837,5,3,2,0.6
barcode08,5,70924951,G,DEL,841,177,9,168,21.05
barcode08,5,70924952,G,DEL,847,1,0,1,0.12
barcode08,5,70924953,G,DEL,850,1,0,1,0.12
barcode08,5,70924954,A,DEL,857,2,2,0,0.23
barcode08,5,70924955,G,DEL,857,3,2,1,0.35
barcode08,5,70924962,A,DEL,874,4,1,3,0.46
barcode08,5,70924963,A,DEL,878,1,1,0,0.11
barcode08,5,70924967,C,DEL,891,4,0,4,0.45
barcode08,5,70924968,T,DEL,894,29,1,28,3.24
barcode08,5,70924969,C,DEL,896,4,0,4,0.45
barcode08,5,70924970,G,DEL,895,3,0,3,0.34
barcode08,5,70924971,T,DEL,895,24,0,24,2.68
barcode08,5,70924972,A,DEL,905,11,6,5,1.22
barcode08,5,70924973,G,DEL,909,8,0,8,0.88
barcode08,5,70924974,A,DEL,929,6,1,5,0.65
barcode08,5,70924980,T,DEL,938,1,1,0,0.11
barcode08,5,70924981,G,DEL,941,16,12,4,1.7
barcode08,5,70924982,A,DEL,945,3,0,3,0.32
barcode08,5,70924983,G,DEL,950,3,0,3,0.32
barcode08,5,70924984,A,DEL,952,13,4,9,1.37
barcode08,5,70924987,T,DEL,965,1,1,0,0.1
barcode08,5,70924988,T,DEL,965,7,7,0,0.73
barcode08,5,70924989,A,DEL,977,8,8,0,0.82
barcode08,5,70924990,C,DEL,976,9,8,1,0.92
barcode08,5,70924991,T,DEL,976,2,0,2,0.2
barcode08,5,70924992,A,DEL,983,1,0,1,0.1
barcode08,5,70924993,C,DEL,988,2,2,0,0.2
barcode08,5,70924994,A,DEL,991,6,4,2,0.61
barcode08,5,70924996,G,DEL,999,3,0,3,0.3
barcode08,5,70924997,C,DEL,998,1,0,1,0.1
barcode08,5,70924999,G,DEL,999,1,0,1,0.1
barcode08,5,70925000,T,DEL,995,44,0,44,4.42
barcode08,5,70925001,C,DEL,997,44,0,44,4.41
barcode08,5,70925002,C,DEL,1004,8,0,8,0.8
barcode08,5,70925003,T,DEL,1006,7,0,7,0.7
barcode08,5,70925004,C,DEL,1019,104,76,28,10.21
barcode08,5,70925006,C,DEL,1024,2,2,0,0.2
barcode08,5,70925007,G,DEL,1022,2,2,0,0.2
barcode08,5,70925010,C,DEL,1021,1,1,0,0.1
barcode08,5,70925011,A,DEL,1024,1,1,0,0.1
barcode08,5,70925012,C,DEL,1027,3,3,0,0.29
barcode08,5,70925014,G,DEL,1026,5,2,3,0.49
barcode08,5,70925015,T,DEL,1025,2,1,1,0.2
barcode08,5,70925016,A,DEL,1025,1,1,0,0.1
barcode08,5,70925017,C,DEL,1031,1,1,0,0.1
barcode08,5,70925018,T,DEL,1032,1,0,1,0.1
barcode08,5,70925020,T,DEL,1035,56,1,55,5.41
barcode08,5,70925021,T,DEL,1038,2,0,2,0.19
barcode08,5,70925022,C,DEL,1040,7,1,6,0.67
barcode08,5,70925023,C,DEL,1044,1,0,1,0.1
barcode08,5,70925024,G,DEL,1042,1,0,1,0.1
barcode08,5,70925026,T,DEL,1049,1,1,0,0.1
barcode08,5,70925027,C,DEL,1052,169,159,10,16.06
barcode08,5,70925030,A,DEL,1055,7,4,3,0.66
barcode08,5,70925031,G,DEL,1055,3,0,3,0.28
barcode08,5,70925032,A,DEL,1056,4,0,4,0.38
barcode08,5,70925035,C,DEL,1055,131,97,34,12.42
barcode08,5,70925036,C,DEL,1058,2,2,0,0.19
barcode08,5,70925037,C,DEL,1064,1,0,1,0.09
barcode08,5,70925038,C,DEL,1064,23,21,2,2.16
barcode08,5,70925039,G,DEL,1066,66,44,22,6.19
barcode08,5,70925043,G,DEL,1067,1,1,0,0.09
barcode08,5,70925044,G,DEL,1071,1,1,0,0.09
barcode08,5,70925045,C,DEL,1068,1,0,1,0.09
barcode08,5,70925046,G,DEL,1068,10,7,3,0.94
barcode08,5,70925047,G,DEL,1068,3,0,3,0.28
barcode08,5,70925048,A,DEL,1065,93,2,91,8.73
barcode08,5,70925049,A,DEL,1058,1,0,1,0.09
barcode08,5,70925052,C,DEL,1057,1,1,0,0.09
barcode08,5,70925058,T,DEL,1065,3,2,1,0.28
barcode08,5,70925059,C,DEL,1071,8,3,5,0.75
barcode08,5,70925060,T,DEL,1071,43,22,21,4.01
barcode08,5,70925061,T,DEL,1069,5,0,5,0.47
barcode08,5,70925062,A,DEL,1063,21,5,16,1.98
barcode08,5,70925063,A,DEL,1063,2,2,0,0.19
barcode08,5,70925064,G,DEL,1061,4,3,1,0.38
barcode08,5,70925065,A,DEL,1058,29,25,4,2.74
barcode08,5,70925066,A,DEL,1060,9,9,0,0.85
barcode08,5,70925067,G,DEL,1057,32,19,13,3.03
barcode08,5,70925068,G,DEL,1046,4,4,0,0.38
barcode08,5,70925069,G,DEL,1046,1,1,0,0.1
barcode08,5,70925071,C,DEL,1040,4,4,0,0.38
barcode08,5,70925072,G,DEL,1038,46,42,4,4.43
barcode08,5,70925073,G,DEL,1027,5,4,1,0.49
barcode08,5,70925074,G,DEL,1018,6,6,0,0.59
barcode08,5,70925075,G,DEL,1002,52,51,1,5.19
barcode08,5,70925076,C,DEL,1001,79,73,6,7.89
barcode08,5,70925077,C,DEL,1013,35,33,2,3.46
barcode08,5,70925078,C,DEL,1012,33,33,0,3.26
barcode08,5,70925079,C,DEL,1016,9,9,0,0.89
barcode08,5,70925080,A,DEL,1014,14,14,0,1.38
barcode08,5,70925081,C,DEL,1023,3,2,1,0.29
barcode08,5,70925082,G,DEL,1024,6,6,0,0.59
barcode08,5,70925084,T,DEL,1027,3,0,3,0.29
barcode08,5,70925085,G,DEL,1028,8,7,1,0.78
barcode08,5,70925086,C,DEL,1027,4,4,0,0.39
barcode08,5,70925088,C,DEL,1025,8,2,6,0.78
barcode08,5,70925089,A,DEL,1022,3,3,0,0.29
barcode08,5,70925090,C,DEL,1021,16,16,0,1.57
barcode08,5,70925091,C,DEL,1012,1,1,0,0.1
barcode08,5,70925092,C,DEL,1005,5,5,0,0.5
barcode08,5,70925093,G,DEL,1007,7,5,2,0.7
barcode08,5,70925094,C,DEL,1008,1,1,0,0.1
barcode08,5,70925095,G,DEL,1007,5,0,5,0.5
barcode08,5,70925097,G,DEL,1001,1,1,0,0.1
barcode08,5,70925098,T,DEL,1004,6,4,2,0.6
barcode08,5,70925100,T,DEL,1005,1,1,0,0.1
barcode08,5,70925101,G,DEL,1011,2,2,0,0.2
barcode08,5,70925102,C,DEL,1009,2,2,0,0.2
barcode08,5,70925103,T,DEL,1006,1,0,1,0.1
barcode08,5,70925108,C,DEL,994,5,0,5,0.5
barcode08,5,70925109,G,DEL,991,10,0,10,1.01
barcode08,5,70925110,A,DEL,987,10,0,10,1.01
barcode08,5,70925111,T,DEL,986,1,1,0,0.1
barcode08,5,70925112,G,DEL,983,2,1,1,0.2
barcode08,5,70925113,A,DEL,980,5,2,3,0.51
barcode08,5,70925114,G,DEL,980,22,2,20,2.24
barcode08,5,70925115,C,DEL,983,22,1,21,2.24
barcode08,5,70925117,G,DEL,984,3,0,3,0.3
barcode08,5,70925118,C,DEL,982,3,0,3,0.31
barcode08,5,70925119,G,DEL,979,3,0,3,0.31
barcode08,5,70925121,C,DEL,975,1,0,1,0.1
barcode08,5,70925124,C,DEL,922,2,0,2,0.22
barcode08,5,70925125,A,DEL,913,3,3,0,0.33
barcode08,5,70925126,G,DEL,913,3,3,0,0.33
barcode08,5,70925127,T,DEL,913,1,1,0,0.11
barcode08,5,70925128,G,DEL,913,1,0,1,0.11
barcode08,5,70925129,G,DEL,907,2,2,0,0.22
barcode08,5,70925130,T,DEL,906,2,2,0,0.22
barcode08,5,70925131,G,DEL,904,2,2,0,0.22
barcode08,5,70925132,G,DEL,903,2,2,0,0.22
barcode08,5,70925133,C,DEL,901,3,3,0,0.33
barcode08,5,70925134,G,DEL,900,7,1,6,0.78
barcode08,5,70925137,G,DEL,883,1,0,1,0.11
barcode08,5,70925138,T,DEL,876,2,2,0,0.23
barcode08,5,70925139,C,DEL,869,29,26,3,3.34
barcode08,5,70925141,C,DEL,867,2,2,0,0.23
barcode08,5,70925142,G,DEL,861,10,6,4,1.16
barcode08,5,70925143,G,DEL,861,5,1,4,0.58
barcode08,5,70925144,A,DEL,853,4,3,1,0.47
barcode08,5,70925145,G,DEL,850,12,5,7,1.41
barcode08,5,70925146,C,DEL,850,7,5,2,0.82
barcode08,5,70925147,A,DEL,847,13,13,0,1.53
barcode08,5,70925148,G,DEL,847,13,13,0,1.53
barcode08,5,70925149,G,DEL,845,8,8,0,0.95
barcode08,5,70925150,A,DEL,840,5,5,0,0.6
barcode08,5,70925151,G,DEL,838,13,12,1,1.55
barcode08,5,70925152,G,DEL,834,13,13,0,1.56
barcode08,5,70925153,A,DEL,834,15,14,1,1.8
barcode08,5,70925154,T,DEL,834,32,29,3,3.84
barcode08,5,70925156,C,DEL,824,4,2,2,0.49
barcode08,5,70925157,C,DEL,821,1,0,1,0.12
barcode08,5,70925158,G,DEL,817,3,0,3,0.37
barcode08,5,70925159,T,DEL,817,3,0,3,0.37
barcode08,5,70925160,G,DEL,788,1,0,1,0.13
barcode08,5,70925161,C,DEL,785,1,1,0,0.13
barcode08,5,70925162,T,DEL,785,2,0,2,0.25
barcode08,5,70925163,G,DEL,783,1,0,1,0.13
barcode08,5,70925164,T,DEL,775,7,6,1,0.9
barcode08,5,70925166,C,DEL,768,2,1,1,0.26
barcode08,5,70925167,C,DEL,764,4,1,3,0.52
barcode08,5,70925168,G,DEL,760,19,3,16,2.5
barcode08,5,70925169,G,DEL,752,3,3,0,0.4
barcode08,5,70925170,C,DEL,737,1,1,0,0.14
barcode08,5,70925171,G,DEL,723,1,1,0,0.14
barcode08,5,70925175,C,DEL,712,3,3,0,0.42
barcode08,5,70925176,A,DEL,699,5,5,0,0.72
barcode08,5,70925178,A,DEL,696,4,4,0,0.57
barcode08,5,70925179,G,DEL,695,1,0,1,0.14
barcode08,5,70925181,C,DEL,687,7,7,0,1.02
barcode08,5,70925184,G,DEL,682,1,0,1,0.15
barcode08,5,70925187,G,DEL,673,2,1,1,0.3
barcode08,5,70925188,A,DEL,670,1,1,0,0.15
barcode08,5,70925192,C,DEL,648,3,3,0,0.46
barcode08,5,70925193,G,DEL,647,4,3,1,0.62
barcode08,5,70925194,C,DEL,642,3,1,2,0.47
barcode08,5,70925195,A,DEL,626,1,1,0,0.16
barcode08,5,70925197,C,DEL,619,5,5,0,0.81
barcode08,5,70925198,C,DEL,609,1,1,0,0.16
barcode08,5,70925199,A,DEL,597,1,1,0,0.17
barcode08,5,70925202,G,DEL,581,2,2,0,0.34
barcode08,5,70925205,G,DEL,568,1,1,0,0.18
barcode08,5,70925206,T,DEL,568,2,2,0,0.35
barcode08,5,70925207,C,DEL,538,10,2,8,1.86
barcode08,5,70925208,T,DEL,527,1,0,1,0.19
barcode08,5,70925209,C,DEL,526,3,3,0,0.57
barcode08,5,70925213,A,DEL,225,7,7,0,3.11
barcode08,5,70938767,C,DEL,291,4,0,4,1.37
barcode08,5,70938768,T,DEL,323,18,8,10,5.57
barcode08,5,70938772,T,DEL,335,6,0,6,1.79
barcode08,5,70938776,A,DEL,353,5,0,5,1.42
barcode08,5,70938781,A,DEL,372,6,6,0,1.61
barcode08,5,70938782,C,DEL,375,4,1,3,1.07
barcode08,5,70938783,A,DEL,378,1,0,1,0.26
barcode08,5,70938784,T,DEL,381,9,7,2,2.36
barcode08,5,70938787,T,DEL,391,2,2,0,0.51
barcode08,5,70938788,C,DEL,399,7,2,5,1.75
barcode08,5,70938789,T,DEL,402,1,1,0,0.25
barcode08,5,70938790,G,DEL,406,10,1,9,2.46
barcode08,5,70938792,T,DEL,410,3,2,1,0.73
barcode08,5,70938794,A,DEL,413,6,0,6,1.45
barcode08,5,70938799,T,DEL,452,2,0,2,0.44
barcode08,5,70938801,T,DEL,458,6,1,5,1.31
barcode08,5,70938802,C,DEL,465,1,1,0,0.22
barcode08,5,70938803,T,DEL,470,1,0,1,0.21
barcode08,5,70938804,G,DEL,472,12,0,12,2.54
barcode08,5,70938805,A,DEL,474,20,0,20,4.22
barcode08,5,70938806,A,DEL,478,1,0,1,0.21
barcode08,5,70938807,C,DEL,519,1,0,1,0.19
barcode08,5,70938808,A,DEL,528,2,0,2,0.38
barcode08,5,70938809,T,DEL,528,1,0,1,0.19
barcode08,5,70938814,T,DEL,565,1,1,0,0.18
barcode08,5,70938815,G,DEL,575,2,2,0,0.35
barcode08,5,70938816,T,DEL,579,59,35,24,10.19
barcode08,5,70938817,T,DEL,582,22,22,0,3.78
barcode08,5,70938818,T,DEL,582,1,1,0,0.17
barcode08,5,70938819,T,DEL,584,1,1,0,0.17
barcode08,5,70938820,T,DEL,584,1,1,0,0.17
barcode08,5,70938821,A,DEL,588,2,2,0,0.34
barcode08,5,70938822,T,DEL,593,5,1,4,0.84
barcode08,5,70938823,T,DEL,594,2,2,0,0.34
barcode08,5,70938824,T,DEL,594,2,2,0,0.34
barcode08,5,70938825,C,DEL,605,2,2,0,0.33
barcode08,5,70938826,T,DEL,606,16,15,1,2.64
barcode08,5,70938827,T,DEL,607,1,0,1,0.16
barcode08,5,70938828,A,DEL,617,2,1,1,0.32
barcode08,5,70938829,C,DEL,617,8,4,4,1.3
barcode08,5,70938830,C,DEL,619,1,0,1,0.16
barcode08,5,70938831,C,DEL,620,1,1,0,0.16
barcode08,5,70938832,T,DEL,620,9,9,0,1.45
barcode08,5,70938833,T,DEL,621,2,2,0,0.32
barcode08,5,70938835,C,DEL,624,2,2,0,0.32
barcode08,5,70938836,C,DEL,628,1,1,0,0.16
barcode08,5,70938837,A,DEL,629,5,5,0,0.79
barcode08,5,70938839,A,DEL,636,1,1,0,0.16
barcode08,5,70938847,T,DEL,635,2,2,0,0.31
barcode08,5,70938848,T,DEL,636,4,4,0,0.63
barcode08,5,70938849,C,DEL,639,8,6,2,1.25
barcode08,5,70938850,T,DEL,640,4,3,1,0.62
barcode08,5,70938851,G,DEL,640,3,0,3,0.47
barcode08,5,70938852,A,DEL,641,2,0,2,0.31
barcode08,5,70938853,C,DEL,640,2,0,2,0.31
barcode08,5,70938855,T,DEL,640,10,6,4,1.56
barcode08,5,70938858,G,DEL,642,31,1,30,4.83
barcode08,5,70938864,A,DEL,640,3,1,2,0.47
barcode08,5,70938865,T,DEL,636,2,0,2,0.31
barcode08,5,70938866,A,DEL,648,1,1,0,0.15
barcode08,5,70938869,G,DEL,649,3,0,3,0.46
barcode08,5,70938873,T,DEL,634,3,1,2,0.47
barcode08,5,70938874,G,DEL,632,2,1,1,0.32
barcode08,5,70938875,A,DEL,637,2,1,1,0.31
barcode08,5,70938876,T,DEL,634,1,0,1,0.16
barcode08,5,70938877,A,DEL,620,15,12,3,2.42
barcode08,5,70938878,A,DEL,620,1,0,1,0.16
barcode08,5,70938880,A,DEL,620,1,0,1,0.16
barcode08,5,70938881,G,DEL,619,1,0,1,0.16
barcode08,5,70938885,A,DEL,614,1,1,0,0.16
barcode08,5,70938886,T,DEL,613,1,1,0,0.16
barcode08,5,70938887,G,DEL,606,2,2,0,0.33
barcode08,5,70938890,A,DEL,581,5,2,3,0.86
barcode08,5,70938900,C,DEL,529,5,0,5,0.95
barcode08,5,70938901,T,DEL,528,4,4,0,0.76
barcode08,5,70938905,T,DEL,505,5,2,3,0.99
barcode08,5,70938907,T,DEL,502,3,0,3,0.6
barcode08,5,70938908,A,DEL,498,11,0,11,2.21
barcode08,5,70938909,A,DEL,497,1,1,0,0.2
barcode08,5,70938910,G,DEL,493,1,1,0,0.2
barcode08,5,70938913,A,DEL,476,2,0,2,0.42
barcode08,5,70938915,G,DEL,470,1,1,0,0.21
barcode08,5,70938916,A,DEL,456,3,3,0,0.66
barcode08,5,70938919,T,DEL,441,13,13,0,2.95
barcode08,5,70938920,G,DEL,436,14,14,0,3.21
barcode08,5,70938921,C,DEL,431,14,13,1,3.25
barcode08,5,70938922,T,DEL,431,13,13,0,3.02
barcode08,5,70938923,T,DEL,426,2,2,0,0.47
barcode08,5,70938924,G,DEL,420,3,3,0,0.71
barcode08,5,70938925,C,DEL,409,3,2,1,0.73
barcode08,5,70938926,T,DEL,408,3,3,0,0.74
barcode08,5,70938928,A,DEL,395,1,1,0,0.25
barcode08,5,70938929,G,DEL,394,2,2,0,0.51
barcode08,5,70938931,C,DEL,385,1,1,0,0.26
barcode08,5,70938933,T,DEL,385,28,27,1,7.27
barcode08,5,70938934,T,DEL,385,1,0,1,0.26
barcode08,5,70938939,T,DEL,377,2,1,1,0.53
barcode08,5,70938940,A,DEL,375,2,1,1,0.53
barcode08,5,70938941,T,DEL,375,33,33,0,8.8
barcode08,5,70938944,T,DEL,357,1,1,0,0.28
barcode08,5,70938945,C,DEL,354,1,1,0,0.28
barcode08,5,70941362,T,DEL,161,1,0,1,0.62
barcode08,5,70941364,T,DEL,173,2,0,2,1.16
barcode08,5,70941366,C,DEL,179,1,0,1,0.56
barcode08,5,70941367,A,DEL,180,1,0,1,0.56
barcode08,5,70941368,T,DEL,181,52,1,51,28.73
barcode08,5,70941369,T,DEL,186,2,0,2,1.08
barcode08,5,70941376,C,DEL,199,1,1,0,0.5
barcode08,5,70941377,C,DEL,200,3,1,2,1.5
barcode08,5,70941378,T,DEL,200,6,0,6,3.0
barcode08,5,70941380,T,DEL,204,14,2,12,6.86
barcode08,5,70941381,T,DEL,204,1,0,1,0.49
barcode08,5,70941383,T,DEL,210,3,0,3,1.43
barcode08,5,70941384,C,DEL,219,32,0,32,14.61
barcode08,5,70941386,T,DEL,226,13,0,13,5.75
barcode08,5,70941390,A,DEL,237,1,1,0,0.42
barcode08,5,70941396,T,DEL,285,7,0,7,2.46
barcode08,5,70941397,A,DEL,290,20,0,20,6.9
barcode08,5,70941398,A,DEL,290,1,0,1,0.34
barcode08,5,70941401,A,DEL,297,1,1,0,0.34
barcode08,5,70941408,A,DEL,316,4,0,4,1.27
barcode08,5,70941411,T,DEL,325,11,9,2,3.38
barcode08,5,70941412,T,DEL,326,1,1,0,0.31
barcode08,5,70941413,T,DEL,327,7,7,0,2.14
barcode08,5,70941414,G,DEL,334,12,12,0,3.59
barcode08,5,70941417,A,DEL,335,17,1,16,5.07
barcode08,5,70941418,A,DEL,336,1,0,1,0.3
barcode08,5,70941420,C,DEL,337,1,0,1,0.3
barcode08,5,70941421,T,DEL,351,6,6,0,1.71
barcode08,5,70941423,C,DEL,365,8,8,0,2.19
barcode08,5,70941424,G,DEL,381,14,0,14,3.67
barcode08,5,70941426,G,DEL,383,1,0,1,0.26
barcode08,5,70941427,T,DEL,387,3,0,3,0.78
barcode08,5,70941428,A,DEL,385,7,2,5,1.82
barcode08,5,70941429,A,DEL,388,1,0,1,0.26
barcode08,5,70941430,A,DEL,389,1,0,1,0.26
barcode08,5,70941431,C,DEL,389,12,9,3,3.08
barcode08,5,70941432,C,DEL,392,1,0,1,0.26
barcode08,5,70941433,A,DEL,392,31,10,21,7.91
barcode08,5,70941439,C,DEL,401,1,0,1,0.25
barcode08,5,70941440,A,DEL,401,1,0,1,0.25
barcode08,5,70941445,T,DEL,401,1,0,1,0.25
barcode08,5,70941446,A,DEL,402,27,7,20,6.72
barcode08,5,70941447,A,DEL,402,1,1,0,0.25
barcode08,5,70941448,A,DEL,401,2,1,1,0.5
barcode08,5,70941449,A,DEL,400,4,1,3,1.0
barcode08,5,70941450,G,DEL,400,5,1,4,1.25
barcode08,5,70941451,A,DEL,402,4,1,3,1.0
barcode08,5,70941458,G,DEL,408,2,2,0,0.49
barcode08,5,70941461,A,DEL,408,21,18,3,5.15
barcode08,5,70941462,A,DEL,412,18,16,2,4.37
barcode08,5,70941463,G,DEL,411,20,16,4,4.87
barcode08,5,70941464,A,DEL,416,9,7,2,2.16
barcode08,5,70941465,A,DEL,416,18,16,2,4.33
barcode08,5,70941466,G,DEL,414,25,24,1,6.04
barcode08,5,70941467,A,DEL,414,6,4,2,1.45
barcode08,5,70941468,A,DEL,414,2,0,2,0.48
barcode08,5,70941469,T,DEL,411,2,0,2,0.49
barcode08,5,70941470,A,DEL,411,19,7,12,4.62
barcode08,5,70941475,C,DEL,409,3,3,0,0.73
barcode08,5,70941477,A,DEL,406,40,9,31,9.85
barcode08,5,70941478,A,DEL,404,2,2,0,0.5
barcode08,5,70941479,A,DEL,398,11,11,0,2.76
barcode08,5,70941480,A,DEL,394,12,11,1,3.05
barcode08,5,70941481,G,DEL,392,12,11,1,3.06
barcode08,5,70941482,A,DEL,391,9,1,8,2.3
barcode08,5,70941483,A,DEL,388,7,7,0,1.8
barcode08,5,70941484,G,DEL,385,8,8,0,2.08
barcode08,5,70941485,A,DEL,383,15,13,2,3.92
barcode08,5,70941488,A,DEL,378,1,1,0,0.26
barcode08,5,70941489,C,DEL,378,3,3,0,0.79
barcode08,5,70941492,C,DEL,377,2,2,0,0.53
barcode08,5,70941494,G,DEL,365,1,0,1,0.27
barcode08,5,70941495,C,DEL,362,14,0,14,3.87
barcode08,5,70941496,T,DEL,362,15,13,2,4.14
barcode08,5,70941498,C,DEL,357,1,1,0,0.28
barcode08,5,70941499,C,DEL,354,1,1,0,0.28
barcode08,5,70941500,T,DEL,354,32,31,1,9.04
barcode08,5,70941501,T,DEL,348,1,0,1,0.29
barcode08,5,70941502,A,DEL,344,6,6,0,1.74
barcode08,5,70941503,C,DEL,340,1,1,0,0.29
barcode08,5,70941504,A,DEL,324,1,0,1,0.31
barcode08,5,70941513,T,DEL,312,13,12,1,4.17
barcode08,5,70941514,T,DEL,312,1,0,1,0.32
barcode08,5,70941516,T,DEL,311,1,1,0,0.32
barcode08,5,70941517,A,DEL,310,6,6,0,1.94
barcode08,5,70941523,T,DEL,305,25,25,0,8.2
barcode08,5,70941524,T,DEL,302,2,2,0,0.66
barcode08,5,70941525,G,DEL,300,6,6,0,2.0
barcode08,5,70941527,G,DEL,295,3,3,0,1.02
barcode08,5,70941529,T,DEL,295,7,7,0,2.37
barcode08,5,70941535,T,DEL,288,13,13,0,4.51
barcode08,5,70942315,A,DEL,75,1,1,0,1.33
barcode08,5,70942320,A,DEL,118,1,0,1,0.85
barcode08,5,70942333,T,DEL,165,10,0,10,6.06
barcode08,5,70942334,A,DEL,167,5,0,5,2.99
barcode08,5,70942339,T,DEL,172,1,0,1,0.58
barcode08,5,70942341,T,DEL,173,14,11,3,8.09
barcode08,5,70942342,T,DEL,208,1,1,0,0.48
barcode08,5,70942344,G,DEL,209,5,0,5,2.39
barcode08,5,70942350,T,DEL,217,18,9,9,8.29
barcode08,5,70942354,G,DEL,262,1,0,1,0.38
barcode08,5,70942355,T,DEL,265,2,0,2,0.75
barcode08,5,70942356,A,DEL,279,1,0,1,0.36
barcode08,5,70942358,T,DEL,283,1,0,1,0.35
barcode08,5,70942359,G,DEL,285,3,3,0,1.05
barcode08,5,70942360,G,DEL,285,2,0,2,0.7
barcode08,5,70942361,A,DEL,286,35,1,34,12.24
barcode08,5,70942363,A,DEL,287,1,0,1,0.35
barcode08,5,70942364,G,DEL,287,2,0,2,0.7
barcode08,5,70942365,T,DEL,289,3,2,1,1.04
barcode08,5,70942366,T,DEL,297,1,1,0,0.34
barcode08,5,70942367,G,DEL,298,23,2,21,7.72
barcode08,5,70942368,G,DEL,300,1,0,1,0.33
barcode08,5,70942371,A,DEL,301,2,0,2,0.66
barcode08,5,70942372,C,DEL,302,8,0,8,2.65
barcode08,5,70942373,A,DEL,303,8,0,8,2.64
barcode08,5,70942376,T,DEL,305,1,1,0,0.33
barcode08,5,70942377,G,DEL,305,1,1,0,0.33
barcode08,5,70942378,T,DEL,308,6,6,0,1.95
barcode08,5,70942380,C,DEL,308,1,0,1,0.32
barcode08,5,70942381,T,DEL,309,1,0,1,0.32
barcode08,5,70942382,G,DEL,309,1,1,0,0.32
barcode08,5,70942383,C,DEL,309,2,2,0,0.65
barcode08,5,70942386,T,DEL,309,7,6,1,2.27
barcode08,5,70942392,C,DEL,310,3,3,0,0.97
barcode08,5,70942393,A,DEL,310,6,0,6,1.94
barcode08,5,70942394,G,DEL,310,7,0,7,2.26
barcode08,5,70942395,A,DEL,310,1,0,1,0.32
barcode08,5,70942396,A,DEL,310,1,1,0,0.32
barcode08,5,70942397,G,DEL,309,2,2,0,0.65
barcode08,5,70942398,A,DEL,309,9,9,0,2.91
barcode08,5,70942402,T,DEL,312,14,14,0,4.49
barcode08,5,70942404,G,DEL,312,3,1,2,0.96
barcode08,5,70942405,C,DEL,313,4,1,3,1.28
barcode08,5,70942407,T,DEL,313,17,10,7,5.43
barcode08,5,70942408,T,DEL,316,2,2,0,0.63
barcode08,5,70942411,C,DEL,320,11,10,1,3.44
barcode08,5,70942412,C,DEL,319,1,1,0,0.31
barcode08,5,70942413,C,DEL,321,1,0,1,0.31
barcode08,5,70942414,A,DEL,321,1,0,1,0.31
barcode08,5,70942418,A,DEL,324,3,3,0,0.93
barcode08,5,70942419,C,DEL,324,2,2,0,0.62
barcode08,5,70942420,C,DEL,325,1,1,0,0.31
barcode08,5,70942421,A,DEL,326,1,1,0,0.31
barcode08,5,70942422,T,DEL,326,1,1,0,0.31
barcode08,5,70942424,G,DEL,332,1,1,0,0.3
barcode08,5,70942426,T,DEL,332,9,9,0,2.71
barcode08,5,70942429,A,DEL,339,1,1,0,0.29
barcode08,5,70942435,T,DEL,337,12,11,1,3.56
barcode08,5,70942437,T,DEL,336,4,4,0,1.19
barcode08,5,70942438,T,DEL,336,19,19,0,5.65
barcode08,5,70942439,A,DEL,336,42,35,7,12.5
barcode08,5,70942440,A,DEL,336,20,19,1,5.95
barcode08,5,70942441,G,DEL,337,15,14,1,4.45
barcode08,5,70942442,A,DEL,340,11,11,0,3.24
barcode08,5,70942443,G,DEL,341,3,3,0,0.88
barcode08,5,70942444,A,DEL,342,11,11,0,3.22
barcode08,5,70942445,G,DEL,341,7,7,0,2.05
barcode08,5,70942446,A,DEL,341,4,2,2,1.17
barcode08,5,70942448,A,DEL,346,1,1,0,0.29
barcode08,5,70942449,C,DEL,346,1,1,0,0.29
barcode08,5,70942450,C,DEL,356,1,1,0,0.28
barcode08,5,70942451,T,DEL,357,3,3,0,0.84
barcode08,5,70942452,G,DEL,359,2,2,0,0.56
barcode08,5,70942455,T,DEL,353,1,1,0,0.28
barcode08,5,70942456,T,DEL,349,1,1,0,0.29
barcode08,5,70942457,G,DEL,352,1,1,0,0.28
barcode08,5,70942459,G,DEL,350,1,1,0,0.29
barcode08,5,70942461,T,DEL,352,1,1,0,0.28
barcode08,5,70942463,T,DEL,348,1,0,1,0.29
barcode08,5,70942464,A,DEL,348,1,0,1,0.29
barcode08,5,70942466,A,DEL,364,1,0,1,0.27
barcode08,5,70942477,A,DEL,353,3,0,3,0.85
barcode08,5,70942478,A,DEL,348,2,0,2,0.57
barcode08,5,70942479,A,DEL,346,1,0,1,0.29
barcode08,5,70942480,T,DEL,346,1,0,1,0.29
barcode08,5,70942481,A,DEL,342,8,5,3,2.34
barcode08,5,70942482,G,DEL,341,5,2,3,1.47
barcode08,5,70942483,A,DEL,340,4,3,1,1.18
barcode08,5,70942484,G,DEL,338,7,6,1,2.07
barcode08,5,70942485,A,DEL,335,7,6,1,2.09
barcode08,5,70942486,G,DEL,333,22,22,0,6.61
barcode08,5,70942487,G,DEL,333,1,1,0,0.3
barcode08,5,70942488,A,DEL,332,2,1,1,0.6
barcode08,5,70942490,C,DEL,328,2,0,2,0.61
barcode08,5,70942491,A,DEL,327,3,2,1,0.92
barcode08,5,70942494,A,DEL,327,4,0,4,1.22
barcode08,5,70942495,T,DEL,326,8,2,6,2.45
barcode08,5,70942496,C,DEL,325,1,1,0,0.31
barcode08,5,70942497,T,DEL,325,2,0,2,0.62
barcode08,5,70942498,G,DEL,324,1,1,0,0.31
barcode08,5,70942499,T,DEL,325,3,3,0,0.92
barcode08,5,70942500,C,DEL,327,1,1,0,0.31
barcode08,5,70942502,G,DEL,325,2,0,2,0.62
barcode08,5,70942504,T,DEL,324,2,2,0,0.62
barcode08,5,70942505,C,DEL,322,1,1,0,0.31
barcode08,5,70942506,T,DEL,322,1,1,0,0.31
barcode08,5,70942507,A,DEL,322,1,1,0,0.31
barcode08,5,70942508,C,DEL,321,4,4,0,1.25
barcode08,5,70942509,T,DEL,321,12,9,3,3.74
barcode08,5,70942510,T,DEL,323,2,1,1,0.62
barcode08,5,70942511,T,DEL,323,39,39,0,12.07
barcode08,5,70942512,C,DEL,324,123,122,1,37.96
barcode08,5,70942513,C,DEL,339,14,14,0,4.13
barcode08,5,70942516,A,DEL,339,1,1,0,0.29
barcode08,5,70942517,A,DEL,339,1,1,0,0.29
barcode08,5,70942519,C,DEL,346,1,1,0,0.29
barcode08,5,70942522,T,DEL,348,1,1,0,0.29
barcode08,5,70942525,A,DEL,344,1,1,0,0.29
barcode08,5,70942526,G,DEL,342,1,1,0,0.29
barcode08,5,70942539,T,DEL,312,1,1,0,0.32
barcode08,5,70942541,G,DEL,310,4,3,1,1.29
barcode08,5,70942542,A,DEL,310,2,1,1,0.65
barcode08,5,70942545,A,DEL,304,2,1,1,0.66
barcode08,5,70942554,A,DEL,293,2,0,2,0.68
barcode08,5,70942557,A,DEL,292,5,5,0,1.71
barcode08,5,70942569,A,DEL,250,40,39,1,16.0
barcode08,5,70942570,A,DEL,249,28,28,0,11.24
barcode08,5,70942571,A,DEL,248,16,16,0,6.45
barcode08,5,70942572,A,DEL,247,5,5,0,2.02
barcode08,5,70942678,A,DEL,169,1,0,1,0.59
barcode08,5,70942681,C,DEL,220,1,0,1,0.45
barcode08,5,70942682,T,DEL,220,1,0,1,0.45
barcode08,5,70942683,T,DEL,221,1,0,1,0.45
barcode08,5,70942689,A,DEL,230,7,1,6,3.04
barcode08,5,70942701,A,DEL,243,2,0,2,0.82
barcode08,5,70942702,T,DEL,243,3,1,2,1.23
barcode08,5,70942703,T,DEL,243,3,1,2,1.23
barcode08,5,70942704,T,DEL,243,2,0,2,0.82
barcode08,5,70942705,T,DEL,243,2,0,2,0.82
barcode08,5,70942706,T,DEL,244,5,0,5,2.05
barcode08,5,70942707,T,DEL,244,9,0,9,3.69
barcode08,5,70942708,C,DEL,244,14,1,13,5.74
barcode08,5,70942709,T,DEL,244,28,3,25,11.48
barcode08,5,70942710,T,DEL,244,2,0,2,0.82
barcode08,5,70942712,T,DEL,245,1,0,1,0.41
barcode08,5,70942713,T,DEL,245,9,0,9,3.67
barcode08,5,70942714,A,DEL,246,16,0,16,6.5
barcode08,5,70942715,A,DEL,246,1,0,1,0.41
barcode08,5,70942717,G,DEL,246,2,0,2,0.81
barcode08,5,70942718,A,DEL,247,2,0,2,0.81
barcode08,5,70942721,G,DEL,247,2,0,2,0.81
barcode08,5,70942722,A,DEL,247,31,2,29,12.55
barcode08,5,70942723,A,DEL,247,3,0,3,1.21
barcode08,5,70942727,G,DEL,248,7,0,7,2.82
barcode08,5,70942734,A,DEL,255,6,0,6,2.35
barcode08,5,70942737,T,DEL,256,1,0,1,0.39
barcode08,5,70942741,A,DEL,263,1,0,1,0.38
barcode08,5,70942745,G,DEL,267,1,0,1,0.37
barcode08,5,70942748,G,DEL,267,1,0,1,0.37
barcode08,5,70942749,A,DEL,267,22,0,22,8.24
barcode08,5,70942754,G,DEL,266,2,0,2,0.75
barcode08,5,70942755,A,DEL,265,3,0,3,1.13
barcode08,5,70942756,G,DEL,264,2,0,2,0.76
barcode08,5,70942757,A,DEL,265,15,1,14,5.66
barcode08,5,70942758,A,DEL,266,1,0,1,0.38
barcode08,5,70942761,C,DEL,273,1,0,1,0.37
barcode08,5,70942764,G,DEL,273,4,3,1,1.47
barcode08,5,70942765,G,DEL,271,1,0,1,0.37
barcode08,5,70942766,T,DEL,271,9,0,9,3.32
barcode08,5,70942767,C,DEL,272,17,0,17,6.25
barcode08,5,70942768,T,DEL,274,1,0,1,0.36
barcode08,5,70942769,C,DEL,276,4,0,4,1.45
barcode08,5,70942771,T,DEL,280,1,0,1,0.36
barcode08,5,70942772,G,DEL,280,3,0,3,1.07
barcode08,5,70942773,G,DEL,280,1,0,1,0.36
barcode08,5,70942774,A,DEL,279,7,0,7,2.51
barcode08,5,70942777,T,DEL,276,1,0,1,0.36
barcode08,5,70942778,A,DEL,276,1,0,1,0.36
barcode08,5,70942782,C,DEL,279,1,1,0,0.36
barcode08,5,70942796,C,DEL,224,7,3,4,3.12
barcode08,5,70942799,A,DEL,207,2,1,1,0.97
barcode08,5,70942800,A,DEL,210,1,0,1,0.48
barcode08,5,70942801,A,DEL,210,1,0,1,0.48
barcode08,5,70942802,T,DEL,210,2,0,2,0.95
barcode08,5,70942803,C,DEL,212,7,0,7,3.3
barcode08,5,70942804,T,DEL,214,1,0,1,0.47
barcode08,5,70942808,C,DEL,236,1,0,1,0.42
barcode08,5,70942819,T,DEL,227,22,4,18,9.69
barcode08,5,70942820,T,DEL,231,2,0,2,0.87
barcode08,5,70942821,T,DEL,229,4,0,4,1.75
barcode08,5,70942822,T,DEL,227,9,0,9,3.96
barcode08,5,70942823,C,DEL,227,14,0,14,6.17
barcode08,5,70942824,T,DEL,227,15,1,14,6.61
barcode08,5,70942825,C,DEL,228,35,8,27,15.35
barcode08,5,70942826,C,DEL,228,12,0,12,5.26
barcode08,5,70942827,C,DEL,226,9,0,9,3.98
barcode08,5,70942828,T,DEL,227,14,0,14,6.17
barcode08,5,70942829,C,DEL,227,15,1,14,6.61
barcode08,5,70942830,C,DEL,230,5,0,5,2.17
barcode08,5,70942831,A,DEL,229,3,0,3,1.31
barcode08,5,70942833,C,DEL,229,1,0,1,0.44
barcode08,5,70942834,A,DEL,226,1,0,1,0.44
barcode08,5,70942835,C,DEL,225,58,44,14,25.78
barcode08,5,70942836,C,DEL,213,5,5,0,2.35
barcode08,5,70942837,C,DEL,213,3,3,0,1.41
barcode08,5,70942838,C,DEL,211,2,2,0,0.95
barcode08,5,70942844,C,DEL,209,2,2,0,0.96
barcode08,5,70942847,G,DEL,208,2,2,0,0.96
barcode08,5,70942852,A,DEL,204,11,7,4,5.39
barcode08,5,70942857,T,DEL,203,4,0,4,1.97
barcode08,5,70942858,G,DEL,203,5,0,5,2.46
barcode08,5,70942861,A,DEL,202,1,0,1,0.5
barcode08,5,70942862,C,DEL,202,1,0,1,0.5
barcode08,5,70942863,C,DEL,202,1,0,1,0.5
barcode08,5,70942866,G,DEL,199,1,1,0,0.5
barcode08,5,70942867,A,DEL,199,11,8,3,5.53
barcode08,5,70942870,G,DEL,199,1,0,1,0.5
barcode08,5,70942872,T,DEL,199,3,0,3,1.51
barcode08,5,70942873,A,DEL,198,2,0,2,1.01
barcode08,5,70942874,A,DEL,198,2,0,2,1.01
barcode08,5,70942875,A,DEL,198,2,0,2,1.01
barcode08,5,70942876,C,DEL,198,3,0,3,1.52
barcode08,5,70942877,C,DEL,197,1,0,1,0.51
barcode08,5,70942878,T,DEL,197,1,1,0,0.51
barcode08,5,70942881,T,DEL,196,5,0,5,2.55
barcode08,5,70942885,A,DEL,192,10,1,9,5.21
barcode08,5,70942886,A,DEL,192,3,0,3,1.56
barcode08,5,70942888,G,DEL,188,2,0,2,1.06
barcode08,5,70942889,T,DEL,188,4,3,1,2.13
barcode08,5,70942895,A,DEL,186,11,9,2,5.91
barcode08,5,70942896,G,DEL,185,12,10,2,6.49
barcode08,5,70942897,A,DEL,179,10,1,9,5.59
barcode08,5,70942902,A,DEL,179,1,1,0,0.56
barcode08,5,70942904,T,DEL,179,4,4,0,2.23
barcode08,5,70942906,A,DEL,176,29,0,29,16.48
barcode08,5,70942908,T,DEL,174,3,3,0,1.72
barcode08,5,70942909,G,DEL,173,3,3,0,1.73
barcode08,5,70942911,C,DEL,170,5,4,1,2.94
barcode08,5,70942912,G,DEL,169,5,1,4,2.96
barcode08,5,70942914,G,DEL,163,1,0,1,0.61
barcode08,5,70942915,A,DEL,157,2,0,2,1.27
barcode08,5,70942918,T,DEL,156,6,3,3,3.85
barcode08,5,70942920,T,DEL,149,1,0,1,0.67
barcode08,5,70942921,A,DEL,149,1,0,1,0.67
barcode08,5,70942924,C,DEL,149,1,1,0,0.67
barcode08,5,70942925,T,DEL,149,1,1,0,0.67
barcode08,5,70942929,T,DEL,142,2,0,2,1.41
barcode08,5,70942931,T,DEL,137,1,1,0,0.73
barcode08,5,70942939,T,DEL,124,2,2,0,1.61
barcode08,5,70944618,A,DEL,340,3,0,3,0.88
barcode08,5,70944625,T,DEL,414,2,0,2,0.48
barcode08,5,70944626,A,DEL,421,13,0,13,3.09
barcode08,5,70944628,G,DEL,431,2,0,2,0.46
barcode08,5,70944633,T,DEL,445,16,1,15,3.6
barcode08,5,70944639,T,DEL,459,16,10,6,3.49
barcode08,5,70944640,T,DEL,461,2,0,2,0.43
barcode08,5,70944641,T,DEL,461,2,0,2,0.43
barcode08,5,70944642,G,DEL,463,9,0,9,1.94
barcode08,5,70944643,A,DEL,465,2,0,2,0.43
barcode08,5,70944646,T,DEL,466,1,0,1,0.21
barcode08,5,70944647,A,DEL,471,1,0,1,0.21
barcode08,5,70944648,T,DEL,473,3,0,3,0.63
barcode08,5,70944649,T,DEL,477,9,0,9,1.89
barcode08,5,70944650,C,DEL,477,10,0,10,2.1
barcode08,5,70944652,T,DEL,479,8,0,8,1.67
barcode08,5,70944653,T,DEL,480,8,0,8,1.67
barcode08,5,70944661,G,DEL,528,2,2,0,0.38
barcode08,5,70944663,T,DEL,533,1,0,1,0.19
barcode08,5,70944664,C,DEL,532,2,0,2,0.38
barcode08,5,70944665,T,DEL,534,11,0,11,2.06
barcode08,5,70944666,A,DEL,535,5,1,4,0.93
barcode08,5,70944668,A,DEL,537,1,0,1,0.19
barcode08,5,70944669,A,DEL,538,2,0,2,0.37
barcode08,5,70944670,T,DEL,541,3,0,3,0.55
barcode08,5,70944671,T,DEL,547,2,0,2,0.37
barcode08,5,70944672,C,DEL,548,1,0,1,0.18
barcode08,5,70944673,A,DEL,550,2,0,2,0.36
barcode08,5,70944676,G,DEL,552,1,1,0,0.18
barcode08,5,70944677,G,DEL,555,1,1,0,0.18
barcode08,5,70944678,C,DEL,559,9,1,8,1.61
barcode08,5,70944679,C,DEL,564,3,1,2,0.53
barcode08,5,70944680,C,DEL,564,3,1,2,0.53
barcode08,5,70944681,A,DEL,566,3,1,2,0.53
barcode08,5,70944682,C,DEL,567,2,1,1,0.35
barcode08,5,70944683,C,DEL,566,2,1,1,0.35
barcode08,5,70944684,A,DEL,570,3,1,2,0.53
barcode08,5,70944685,C,DEL,570,5,2,3,0.88
barcode08,5,70944686,C,DEL,568,5,2,3,0.88
barcode08,5,70944687,G,DEL,572,4,1,3,0.7
barcode08,5,70944688,C,DEL,578,1,0,1,0.17
barcode08,5,70944689,C,DEL,578,1,0,1,0.17
barcode08,5,70944690,A,DEL,589,1,0,1,0.17
barcode08,5,70944691,C,DEL,589,5,4,1,0.85
barcode08,5,70944692,C,DEL,592,4,3,1,0.68
barcode08,5,70944693,G,DEL,603,4,1,3,0.66
barcode08,5,70944694,C,DEL,605,13,1,12,2.15
barcode08,5,70944695,C,DEL,608,13,1,12,2.14
barcode08,5,70944696,A,DEL,620,13,1,12,2.1
barcode08,5,70944697,C,DEL,622,7,5,2,1.13
barcode08,5,70944698,C,DEL,622,2,0,2,0.32
barcode08,5,70944699,A,DEL,630,2,0,2,0.32
barcode08,5,70944703,C,DEL,649,1,1,0,0.15
barcode08,5,70944704,C,DEL,649,3,0,3,0.46
barcode08,5,70944705,A,DEL,657,3,0,3,0.46
barcode08,5,70944706,C,DEL,657,74,70,4,11.26
barcode08,5,70944707,C,DEL,656,4,0,4,0.61
barcode08,5,70944711,C,DEL,659,1,0,1,0.15
barcode08,5,70944712,T,DEL,658,6,4,2,0.91
barcode08,5,70944714,A,DEL,654,14,13,1,2.14
barcode08,5,70944715,C,DEL,654,2,1,1,0.31
barcode08,5,70944722,G,DEL,636,2,1,1,0.31
barcode08,5,70944723,C,DEL,640,9,1,8,1.41
barcode08,5,70944724,T,DEL,638,11,1,10,1.72
barcode08,5,70944725,G,DEL,637,2,1,1,0.31
barcode08,5,70944727,C,DEL,636,1,0,1,0.16
barcode08,5,70944729,G,DEL,638,2,1,1,0.31
barcode08,5,70944730,C,DEL,642,6,0,6,0.93
barcode08,5,70944733,C,DEL,640,1,0,1,0.16
barcode08,5,70944735,A,DEL,638,1,0,1,0.16
barcode08,5,70944736,T,DEL,638,8,4,4,1.25
barcode08,5,70944739,C,DEL,636,2,0,2,0.31
barcode08,5,70944740,C,DEL,636,1,0,1,0.16
barcode08,5,70944741,T,DEL,637,9,0,9,1.41
barcode08,5,70944742,T,DEL,638,5,3,2,0.78
barcode08,5,70944743,C,DEL,640,6,3,3,0.94
barcode08,5,70944744,T,DEL,638,4,0,4,0.63
barcode08,5,70944755,T,DEL,628,3,1,2,0.48
barcode08,5,70944756,A,DEL,617,9,1,8,1.46
barcode08,5,70944757,A,DEL,615,9,1,8,1.46
barcode08,5,70944758,G,DEL,615,8,0,8,1.3
barcode08,5,70944759,T,DEL,614,32,0,32,5.21
barcode08,5,70944760,A,DEL,605,125,4,121,20.66
barcode08,5,70944761,A,DEL,604,57,0,57,9.44
barcode08,5,70944762,A,DEL,604,48,0,48,7.95
barcode08,5,70944763,A,DEL,600,16,0,16,2.67
barcode08,5,70944764,A,DEL,599,1,0,1,0.17
barcode08,5,70944765,A,DEL,598,1,0,1,0.17
barcode08,5,70944766,G,DEL,595,3,1,2,0.5
barcode08,5,70944767,A,DEL,595,1,1,0,0.17
barcode08,5,70944768,G,DEL,594,1,0,1,0.17
barcode08,5,70944769,T,DEL,593,30,0,30,5.06
barcode08,5,70944770,A,DEL,591,1,0,1,0.17
barcode08,5,70944771,T,DEL,591,1,0,1,0.17
barcode08,5,70944777,A,DEL,580,6,0,6,1.03
barcode08,5,70944778,G,DEL,577,8,2,6,1.39
barcode08,5,70944780,T,DEL,569,19,6,13,3.34
barcode08,5,70944786,T,DEL,563,4,1,3,0.71
barcode08,5,70944790,A,DEL,547,4,0,4,0.73
barcode08,5,70944793,T,DEL,537,1,0,1,0.19
barcode08,5,70944794,A,DEL,522,2,2,0,0.38
barcode08,5,70944795,C,DEL,516,1,1,0,0.19
barcode08,5,70944798,T,DEL,510,7,5,2,1.37
barcode08,5,70944803,T,DEL,485,1,0,1,0.21
barcode08,5,70944804,A,DEL,474,1,0,1,0.21
barcode08,5,70944805,A,DEL,474,1,0,1,0.21
barcode08,5,70944809,G,DEL,465,2,0,2,0.43
barcode08,5,70944813,A,DEL,438,6,6,0,1.37
barcode08,5,70944816,A,DEL,403,5,5,0,1.24
barcode08,5,70944817,G,DEL,395,3,3,0,0.76
barcode08,5,70944819,G,DEL,380,9,9,0,2.37
barcode08,5,70944820,G,DEL,374,2,2,0,0.53
barcode08,5,70944821,A,DEL,370,2,2,0,0.54
barcode08,5,70944822,T,DEL,370,2,2,0,0.54
barcode08,5,70944824,G,DEL,364,1,1,0,0.27
barcode08,5,70944825,T,DEL,354,4,0,4,1.13
barcode08,5,70944826,A,DEL,338,20,18,2,5.92
barcode08,5,70945984,C,DEL,680,16,0,16,2.35
barcode08,5,70945985,C,DEL,694,1,0,1,0.14
barcode08,5,70945986,A,DEL,738,1,0,1,0.14
barcode08,5,70945987,G,DEL,742,1,0,1,0.13
barcode08,5,70945990,T,DEL,775,7,7,0,0.9
barcode08,5,70945994,C,DEL,821,3,3,0,0.37
barcode08,5,70945995,T,DEL,823,7,3,4,0.85
barcode08,5,70945996,A,DEL,837,8,3,5,0.96
barcode08,5,70945997,T,DEL,844,2,0,2,0.24
barcode08,5,70945998,A,DEL,851,2,0,2,0.24
barcode08,5,70945999,T,DEL,851,3,0,3,0.35
barcode08,5,70946000,A,DEL,855,9,0,9,1.05
barcode08,5,70946001,A,DEL,860,2,2,0,0.23
barcode08,5,70946002,T,DEL,861,4,2,2,0.46
barcode08,5,70946005,A,DEL,880,8,1,7,0.91
barcode08,5,70946006,A,DEL,882,1,0,1,0.11
barcode08,5,70946011,C,DEL,908,2,0,2,0.22
barcode08,5,70946012,C,DEL,911,8,0,8,0.88
barcode08,5,70946013,A,DEL,913,21,0,21,2.3
barcode08,5,70946014,G,DEL,913,23,1,22,2.52
barcode08,5,70946015,A,DEL,923,2,1,1,0.22
barcode08,5,70946016,C,DEL,925,4,1,3,0.43
barcode08,5,70946017,T,DEL,931,12,11,1,1.29
barcode08,5,70946018,T,DEL,932,3,2,1,0.32
barcode08,5,70946019,T,DEL,932,6,5,1,0.64
barcode08,5,70946020,A,DEL,937,6,6,0,0.64
barcode08,5,70946021,C,DEL,940,2,2,0,0.21
barcode08,5,70946022,T,DEL,945,99,22,77,10.48
barcode08,5,70946023,T,DEL,950,2,0,2,0.21
barcode08,5,70946029,T,DEL,1004,8,3,5,0.8
barcode08,5,70946032,A,DEL,1066,3,3,0,0.28
barcode08,5,70946033,C,DEL,1070,18,0,18,1.68
barcode08,5,70946035,G,DEL,1082,2,0,2,0.18
barcode08,5,70946036,G,DEL,1083,1,0,1,0.09
barcode08,5,70946037,A,DEL,1088,14,1,13,1.29
barcode08,5,70946038,T,DEL,1088,14,1,13,1.29
barcode08,5,70946040,T,DEL,1087,1,1,0,0.09
barcode08,5,70946041,A,DEL,1090,56,1,55,5.14
barcode08,5,70946045,A,DEL,1100,9,0,9,0.82
barcode08,5,70946046,A,DEL,1100,5,5,0,0.45
barcode08,5,70946047,T,DEL,1100,8,8,0,0.73
barcode08,5,70946048,A,DEL,1111,4,0,4,0.36
barcode08,5,70946049,T,DEL,1112,1,1,0,0.09
barcode08,5,70946050,C,DEL,1113,7,1,6,0.63
barcode08,5,70946051,T,DEL,1116,158,116,42,14.16
barcode08,5,70946052,T,DEL,1119,31,26,5,2.77
barcode08,5,70946053,T,DEL,1119,16,14,2,1.43
barcode08,5,70946054,T,DEL,1123,8,7,1,0.71
barcode08,5,70946055,T,DEL,1126,14,11,3,1.24
barcode08,5,70946056,C,DEL,1133,15,12,3,1.32
barcode08,5,70946057,T,DEL,1138,10,1,9,0.88
barcode08,5,70946058,G,DEL,1140,1,1,0,0.09
barcode08,5,70946059,T,DEL,1144,1,1,0,0.09
barcode08,5,70946060,C,DEL,1150,46,1,45,4.0
barcode08,5,70946061,T,DEL,1166,2,2,0,0.17
barcode08,5,70946062,C,DEL,1169,6,6,0,0.51
barcode08,5,70946063,C,DEL,1177,2,0,2,0.17
barcode08,5,70946064,A,DEL,1178,6,2,4,0.51
barcode08,5,70946065,G,DEL,1181,15,3,12,1.27
barcode08,5,70946066,A,DEL,1181,48,0,48,4.06
barcode08,5,70946067,T,DEL,1181,52,0,52,4.4
barcode08,5,70946068,A,DEL,1193,5,1,4,0.42
barcode08,5,70946069,A,DEL,1193,4,0,4,0.34
barcode08,5,70946070,T,DEL,1204,8,2,6,0.66
barcode08,5,70946071,T,DEL,1207,7,3,4,0.58
barcode08,5,70946072,C,DEL,1208,281,77,204,23.26
barcode08,5,70946073,C,DEL,1215,46,20,26,3.79
barcode08,5,70946074,C,DEL,1219,11,7,4,0.9
barcode08,5,70946075,C,DEL,1222,9,3,6,0.74
barcode08,5,70946076,C,DEL,1220,9,3,6,0.74
barcode08,5,70946077,A,DEL,1222,9,4,5,0.74
barcode08,5,70946078,C,DEL,1220,1,1,0,0.08
barcode08,5,70946079,C,DEL,1219,1,1,0,0.08
barcode08,5,70946080,A,DEL,1223,1,1,0,0.08
barcode08,5,70946081,C,DEL,1222,8,1,7,0.65
barcode08,5,70946082,C,DEL,1227,1,0,1,0.08
barcode08,5,70946084,C,DEL,1231,190,188,2,15.43
barcode08,5,70946087,A,DEL,1235,32,4,28,2.59
barcode08,5,70946088,T,DEL,1234,33,4,29,2.67
barcode08,5,70946089,A,DEL,1225,1,1,0,0.08
barcode08,5,70946090,T,DEL,1224,3,3,0,0.25
barcode08,5,70946091,G,DEL,1221,3,3,0,0.25
barcode08,5,70946093,C,DEL,1227,6,6,0,0.49
barcode08,5,70946096,G,DEL,1232,10,1,9,0.81
barcode08,5,70946097,A,DEL,1238,5,3,2,0.4
barcode08,5,70946098,T,DEL,1244,14,1,13,1.13
barcode08,5,70946099,T,DEL,1239,213,8,205,17.19
barcode08,5,70946100,C,DEL,1237,220,9,211,17.78
barcode08,5,70946102,C,DEL,1239,6,4,2,0.48
barcode08,5,70946103,T,DEL,1248,32,12,20,2.56
barcode08,5,70946104,T,DEL,1248,27,1,26,2.16
barcode08,5,70946105,G,DEL,1245,37,1,36,2.97
barcode08,5,70946106,A,DEL,1247,1,1,0,0.08
barcode08,5,70946107,T,DEL,1243,1,0,1,0.08
barcode08,5,70946108,G,DEL,1239,1,0,1,0.08
barcode08,5,70946109,A,DEL,1243,1,0,1,0.08
barcode08,5,70946110,T,DEL,1237,2,1,1,0.16
barcode08,5,70946111,G,DEL,1238,2,1,1,0.16
barcode08,5,70946112,C,DEL,1247,2,1,1,0.16
barcode08,5,70946114,G,DEL,1249,1,0,1,0.08
barcode08,5,70946116,T,DEL,1251,1,0,1,0.08
barcode08,5,70946117,G,DEL,1243,1,0,1,0.08
barcode08,5,70946118,C,DEL,1237,7,0,7,0.57
barcode08,5,70946119,T,DEL,1247,7,4,3,0.56
barcode08,5,70946121,T,DEL,1263,2,0,2,0.16
barcode08,5,70946122,G,DEL,1269,107,3,104,8.43
barcode08,5,70946124,G,DEL,1274,5,0,5,0.39
barcode08,5,70946125,A,DEL,1272,22,1,21,1.73
barcode08,5,70946126,A,DEL,1273,1,1,0,0.08
barcode08,5,70946127,G,DEL,1266,20,6,14,1.58
barcode08,5,70946128,T,DEL,1261,46,2,44,3.65
barcode08,5,70946129,A,DEL,1284,2,2,0,0.16
barcode08,5,70946130,T,DEL,1284,1,1,0,0.08
barcode08,5,70946131,G,DEL,1285,1,1,0,0.08
barcode08,5,70946132,T,DEL,1289,145,145,0,11.25
barcode08,5,70946134,A,DEL,1288,10,1,9,0.78
barcode08,5,70946136,T,DEL,1294,13,4,9,1.0
barcode08,5,70946139,C,DEL,1329,1,1,0,0.08
barcode08,5,70946143,G,DEL,1327,3,0,3,0.23
barcode08,5,70946144,T,DEL,1330,13,1,12,0.98
barcode08,5,70946145,A,DEL,1322,1,1,0,0.08
barcode08,5,70946147,A,DEL,1331,1,1,0,0.08
barcode08,5,70946150,A,DEL,1343,4,4,0,0.3
barcode08,5,70946151,G,DEL,1334,4,4,0,0.3
barcode08,5,70946152,T,DEL,1338,3,3,0,0.22
barcode08,5,70946153,G,DEL,1336,1,0,1,0.07
barcode08,5,70946154,G,DEL,1338,1,0,1,0.07
barcode08,5,70946155,C,DEL,1332,2,0,2,0.15
barcode08,5,70946156,T,DEL,1333,1,0,1,0.08
barcode08,5,70946157,A,DEL,1322,1,1,0,0.08
barcode08,5,70946158,T,DEL,1327,1,1,0,0.08
barcode08,5,70946159,C,DEL,1299,1,1,0,0.08
barcode08,5,70946160,A,DEL,1297,2,1,1,0.15
barcode08,5,70946161,T,DEL,1296,4,1,3,0.31
barcode08,5,70946162,A,DEL,1354,4,1,3,0.3
barcode08,5,70946163,C,DEL,1352,4,1,3,0.3
barcode08,5,70946164,T,DEL,1356,2,1,1,0.15
barcode08,5,70946165,G,DEL,1362,2,1,1,0.15
barcode08,5,70946166,G,DEL,1362,1,1,0,0.07
barcode08,5,70946167,C,DEL,1351,2,2,0,0.15
barcode08,5,70946168,T,DEL,1352,4,4,0,0.3
barcode08,5,70946169,A,DEL,1326,4,4,0,0.3
barcode08,5,70946170,T,DEL,1322,12,12,0,0.91
barcode08,5,70946171,T,DEL,1320,27,27,0,2.05
barcode08,5,70946172,A,DEL,1330,28,28,0,2.11
barcode08,5,70946173,T,DEL,1329,6,3,3,0.45
barcode08,5,70946174,A,DEL,1353,6,6,0,0.44
barcode08,5,70946175,T,DEL,1356,2,0,2,0.15
barcode08,5,70946176,G,DEL,1351,1,0,1,0.07
barcode08,5,70946177,G,DEL,1371,20,0,20,1.46
barcode08,5,70946178,T,DEL,1372,27,1,26,1.97
barcode08,5,70946179,A,DEL,1334,15,4,11,1.12
barcode08,5,70946180,A,DEL,1339,10,0,10,0.75
barcode08,5,70946181,G,DEL,1336,13,0,13,0.97
barcode08,5,70946182,T,DEL,1341,12,0,12,0.89
barcode08,5,70946183,A,DEL,1320,35,0,35,2.65
barcode08,5,70946185,T,DEL,1340,1,1,0,0.07
barcode08,5,70946186,C,DEL,1337,1,1,0,0.07
barcode08,5,70946187,A,DEL,1337,1,1,0,0.07
barcode08,5,70946188,C,DEL,1338,1,1,0,0.07
barcode08,5,70946189,T,DEL,1348,1,0,1,0.07
barcode08,5,70946190,C,DEL,1343,54,0,54,4.02
barcode08,5,70946192,G,DEL,1346,4,2,2,0.3
barcode08,5,70946194,A,DEL,1345,1,0,1,0.07
barcode08,5,70946195,T,DEL,1345,2,1,1,0.15
barcode08,5,70946196,C,DEL,1341,8,2,6,0.6
barcode08,5,70946197,T,DEL,1343,321,284,37,23.9
barcode08,5,70946198,T,DEL,1345,13,13,0,0.97
barcode08,5,70946199,T,DEL,1348,2,2,0,0.15
barcode08,5,70946200,T,DEL,1349,3,0,3,0.22
barcode08,5,70946201,C,DEL,1351,9,4,5,0.67
barcode08,5,70946202,C,DEL,1355,3,2,1,0.22
barcode08,5,70946203,T,DEL,1353,4,0,4,0.3
barcode08,5,70946204,G,DEL,1353,22,1,21,1.63
barcode08,5,70946205,A,DEL,1349,2,1,1,0.15
barcode08,5,70946206,C,DEL,1342,3,1,2,0.22
barcode08,5,70946208,A,DEL,1341,1,0,1,0.07
barcode08,5,70946209,T,DEL,1344,72,64,8,5.36
barcode08,5,70946210,T,DEL,1348,5,3,2,0.37
barcode08,5,70946211,T,DEL,1350,2,1,1,0.15
barcode08,5,70946212,T,DEL,1348,1,0,1,0.07
barcode08,5,70946215,T,DEL,1366,5,1,4,0.37
barcode08,5,70946216,G,DEL,1381,5,1,4,0.36
barcode08,5,70946218,A,DEL,1391,1,1,0,0.07
barcode08,5,70946219,G,DEL,1387,1,1,0,0.07
barcode08,5,70946225,T,DEL,1376,3,3,0,0.22
barcode08,5,70946228,C,DEL,1374,2,0,2,0.15
barcode08,5,70946229,T,DEL,1372,21,21,0,1.53
barcode08,5,70946230,T,DEL,1340,1,1,0,0.07
barcode08,5,70946233,T,DEL,1338,49,36,13,3.66
barcode08,5,70946234,T,DEL,1340,1,1,0,0.07
barcode08,5,70946236,T,DEL,1334,2,1,1,0.15
barcode08,5,70946237,G,DEL,1336,2,1,1,0.15
barcode08,5,70946238,T,DEL,1337,2,1,1,0.15
barcode08,5,70946239,A,DEL,1330,19,15,4,1.43
barcode08,5,70946241,A,DEL,1323,3,2,1,0.23
barcode08,5,70946242,T,DEL,1320,26,6,20,1.97
barcode08,5,70946243,T,DEL,1317,2,2,0,0.15
barcode08,5,70946244,T,DEL,1316,11,11,0,0.84
barcode08,5,70946245,A,DEL,1309,16,16,0,1.22
barcode08,5,70946246,T,DEL,1304,1,1,0,0.08
barcode08,5,70946247,A,DEL,1293,44,20,24,3.4
barcode08,5,70946248,A,DEL,1293,2,0,2,0.15
barcode08,5,70946251,T,DEL,1279,1,1,0,0.08
barcode08,5,70946252,A,DEL,1277,1,1,0,0.08
barcode08,5,70946253,C,DEL,1276,5,5,0,0.39
barcode08,5,70946255,A,DEL,1275,4,4,0,0.31
barcode08,5,70946256,C,DEL,1272,3,3,0,0.24
barcode08,5,70946257,T,DEL,1269,5,5,0,0.39
barcode08,5,70946260,C,DEL,1257,10,9,1,0.8
barcode08,5,70946261,T,DEL,1256,22,21,1,1.75
barcode08,5,70946262,T,DEL,1245,23,20,3,1.85
barcode08,5,70946263,C,DEL,1242,27,22,5,2.17
barcode08,5,70946264,T,DEL,1241,1,0,1,0.08
barcode08,5,70946265,C,DEL,1232,3,1,2,0.24
barcode08,5,70946266,T,DEL,1223,4,1,3,0.33
barcode08,5,70946267,C,DEL,1211,12,9,3,0.99
barcode08,5,70946268,T,DEL,1198,118,109,9,9.85
barcode08,5,70946269,T,DEL,1191,9,2,7,0.76
barcode08,5,70946270,T,DEL,1182,8,0,8,0.68
barcode08,5,70946271,A,DEL,1168,1,0,1,0.09
barcode08,5,70946272,T,DEL,1167,1,1,0,0.09
barcode08,5,70946273,A,DEL,1141,5,3,2,0.44
barcode08,5,70946274,T,DEL,1141,3,3,0,0.26
barcode08,5,70946275,T,DEL,1140,5,5,0,0.44
barcode08,5,70946276,A,DEL,1135,16,16,0,1.41
barcode08,5,70946277,C,DEL,1133,6,6,0,0.53
barcode08,5,70946279,A,DEL,1112,24,18,6,2.16
barcode08,5,70946281,A,DEL,1104,1,1,0,0.09
barcode08,5,70946282,A,DEL,1099,1,1,0,0.09
barcode08,5,70946283,A,DEL,1093,1,1,0,0.09
barcode08,5,70946284,A,DEL,1090,1,1,0,0.09
barcode08,5,70946285,T,DEL,1090,1,1,0,0.09
barcode08,5,70946286,A,DEL,1082,31,31,0,2.87
barcode08,5,70946287,A,DEL,1082,1,1,0,0.09
barcode08,5,70946288,A,DEL,1082,1,1,0,0.09
barcode08,5,70946289,A,DEL,1079,1,1,0,0.09
barcode08,5,70946290,A,DEL,1078,1,1,0,0.09
barcode08,5,70946291,T,DEL,1078,1,1,0,0.09
barcode08,5,70946292,A,DEL,1051,129,125,4,12.27
barcode08,5,70946293,A,DEL,1046,32,32,0,3.06
barcode08,5,70946294,A,DEL,1034,9,9,0,0.87
barcode08,5,70946295,A,DEL,1025,2,2,0,0.2
barcode08,5,70946299,T,DEL,992,2,2,0,0.2
barcode08,5,70946300,A,DEL,974,3,2,1,0.31
barcode08,5,70946301,C,DEL,964,2,1,1,0.21
barcode08,5,70946305,T,DEL,934,6,6,0,0.64
barcode08,5,70946306,G,DEL,913,6,6,0,0.66
barcode08,5,70946307,T,DEL,905,2,2,0,0.22
barcode08,5,70946308,C,DEL,788,5,4,1,0.63
barcode08,5,70946315,T,DEL,619,2,2,0,0.32
barcode08,5,70951943,T,DEL,692,19,2,17,2.75
barcode08,5,70951946,C,DEL,713,2,1,1,0.28
barcode08,5,70951947,A,DEL,715,6,1,5,0.84
barcode08,5,70951948,G,DEL,715,12,1,11,1.68
barcode08,5,70951949,A,DEL,715,6,1,5,0.84
barcode08,5,70951950,C,DEL,716,5,0,5,0.7
barcode08,5,70951951,A,DEL,719,110,5,105,15.3
barcode08,5,70951952,A,DEL,722,1,0,1,0.14
barcode08,5,70951957,A,DEL,728,108,11,97,14.84
barcode08,5,70951958,A,DEL,731,24,2,22,3.28
barcode08,5,70951959,A,DEL,732,3,0,3,0.41
barcode08,5,70951962,G,DEL,737,2,1,1,0.27
barcode08,5,70951963,A,DEL,742,66,2,64,8.89
barcode08,5,70951964,A,DEL,746,1,1,0,0.13
barcode08,5,70951965,G,DEL,746,2,1,1,0.27
barcode08,5,70951966,G,DEL,751,1,0,1,0.13
barcode08,5,70951967,A,DEL,754,45,1,44,5.97
barcode08,5,70951969,G,DEL,759,2,2,0,0.26
barcode08,5,70951972,G,DEL,763,1,1,0,0.13
barcode08,5,70951973,C,DEL,770,10,0,10,1.3
barcode08,5,70951975,C,DEL,781,6,0,6,0.77
barcode08,5,70951976,A,DEL,783,5,0,5,0.64
barcode08,5,70951977,C,DEL,786,2,0,2,0.25
barcode08,5,70951978,A,DEL,789,6,0,6,0.76
barcode08,5,70951979,T,DEL,793,5,3,2,0.63
barcode08,5,70951980,T,DEL,794,3,0,3,0.38
barcode08,5,70951981,C,DEL,795,5,0,5,0.63
barcode08,5,70951983,T,DEL,804,12,3,9,1.49
barcode08,5,70951984,T,DEL,805,9,1,8,1.12
barcode08,5,70951985,A,DEL,808,12,4,8,1.49
barcode08,5,70951990,A,DEL,819,10,1,9,1.22
barcode08,5,70951991,A,DEL,823,1,1,0,0.12
barcode08,5,70951992,G,DEL,822,1,0,1,0.12
barcode08,5,70951993,G,DEL,828,4,3,1,0.48
barcode08,5,70951994,A,DEL,832,6,4,2,0.72
barcode08,5,70951995,G,DEL,835,8,1,7,0.96
barcode08,5,70951996,T,DEL,836,6,0,6,0.72
barcode08,5,70951997,A,DEL,842,2,0,2,0.24
barcode08,5,70951998,A,DEL,848,2,0,2,0.24
barcode08,5,70952000,T,DEL,858,4,2,2,0.47
barcode08,5,70952001,C,DEL,867,7,3,4,0.81
barcode08,5,70952002,T,DEL,873,3,0,3,0.34
barcode08,5,70952003,G,DEL,909,3,0,3,0.33
barcode08,5,70952004,C,DEL,934,11,5,6,1.18
barcode08,5,70952005,C,DEL,932,5,0,5,0.54
barcode08,5,70952007,G,DEL,945,2,1,1,0.21
barcode08,5,70952010,T,DEL,943,2,1,1,0.21
barcode08,5,70952011,T,DEL,944,2,2,0,0.21
barcode08,5,70952012,A,DEL,951,2,2,0,0.21
barcode08,5,70952015,A,DEL,960,125,18,107,13.02
barcode08,5,70952019,T,DEL,961,1,0,1,0.1
barcode08,5,70952020,G,DEL,962,3,0,3,0.31
barcode08,5,70952023,T,DEL,970,2,1,1,0.21
barcode08,5,70952024,C,DEL,968,3,1,2,0.31
barcode08,5,70952025,T,DEL,968,8,5,3,0.83
barcode08,5,70952026,T,DEL,968,2,0,2,0.21
barcode08,5,70952028,C,DEL,977,1,1,0,0.1
barcode08,5,70952029,T,DEL,979,69,5,64,7.05
barcode08,5,70952031,T,DEL,976,3,3,0,0.31
barcode08,5,70952032,T,DEL,971,5,5,0,0.51
barcode08,5,70952033,G,DEL,981,5,5,0,0.51
barcode08,5,70952034,T,DEL,980,21,0,21,2.14
barcode08,5,70952035,A,DEL,975,10,3,7,1.03
barcode08,5,70952036,A,DEL,978,1,0,1,0.1
barcode08,5,70952040,T,DEL,973,1,0,1,0.1
barcode08,5,70952047,T,DEL,990,3,0,3,0.3
barcode08,5,70952050,G,DEL,1041,1,0,1,0.1
barcode08,5,70952051,T,DEL,1052,1,0,1,0.1
barcode08,5,70952052,G,DEL,1052,10,8,2,0.95
barcode08,5,70952053,G,DEL,1051,1,0,1,0.1
barcode08,5,70952054,A,DEL,1046,10,2,8,0.96
barcode08,5,70952055,A,DEL,1035,1,0,1,0.1
barcode08,5,70952058,C,DEL,1033,1,0,1,0.1
barcode08,5,70952059,A,DEL,1030,56,0,56,5.44
barcode08,5,70952061,A,DEL,1031,1,0,1,0.1
barcode08,5,70952062,T,DEL,1031,2,1,1,0.19
barcode08,5,70952063,G,DEL,1030,1,1,0,0.1
barcode08,5,70952064,T,DEL,1027,56,9,47,5.45
barcode08,5,70952065,T,DEL,1029,5,0,5,0.49
barcode08,5,70952068,T,DEL,1036,1,0,1,0.1
barcode08,5,70952069,G,DEL,1032,7,0,7,0.68
barcode08,5,70952070,A,DEL,1046,9,0,9,0.86
barcode08,5,70952071,A,DEL,1049,2,0,2,0.19
barcode08,5,70952072,C,DEL,1051,3,2,1,0.29
barcode08,5,70952074,T,DEL,1046,14,7,7,1.34
barcode08,5,70952075,T,DEL,1044,3,2,1,0.29
barcode08,5,70952076,T,DEL,1039,5,0,5,0.48
barcode08,5,70952077,A,DEL,1039,100,6,94,9.62
barcode08,5,70952078,A,DEL,1044,28,1,27,2.68
barcode08,5,70952079,A,DEL,1045,1,0,1,0.1
barcode08,5,70952082,G,DEL,1049,1,0,1,0.1
barcode08,5,70952083,T,DEL,1057,19,19,0,1.8
barcode08,5,70952084,T,DEL,1058,6,6,0,0.57
barcode08,5,70952085,C,DEL,1061,24,20,4,2.26
barcode08,5,70952086,A,DEL,1060,17,1,16,1.6
barcode08,5,70952087,G,DEL,1061,24,2,22,2.26
barcode08,5,70952091,T,DEL,1070,12,12,0,1.12
barcode08,5,70952093,A,DEL,1145,36,3,33,3.14
barcode08,5,70952094,A,DEL,1110,3,0,3,0.27
barcode08,5,70952095,A,DEL,1118,1,0,1,0.09
barcode08,5,70952097,A,DEL,1113,4,1,3,0.36
barcode08,5,70952098,G,DEL,1099,9,3,6,0.82
barcode08,5,70952099,T,DEL,1106,14,8,6,1.27
barcode08,5,70952101,G,DEL,1107,1,1,0,0.09
barcode08,5,70952102,A,DEL,1125,49,1,48,4.36
barcode08,5,70952103,A,DEL,1127,1,0,1,0.09
barcode08,5,70952105,G,DEL,1120,1,0,1,0.09
barcode08,5,70952107,T,DEL,1133,4,3,1,0.35
barcode08,5,70952108,T,DEL,1129,1,1,0,0.09
barcode08,5,70952109,A,DEL,1129,4,1,3,0.35
barcode08,5,70952110,A,DEL,1131,1,1,0,0.09
barcode08,5,70952111,T,DEL,1129,4,2,2,0.35
barcode08,5,70952112,G,DEL,1130,3,2,1,0.27
barcode08,5,70952113,T,DEL,1127,24,0,24,2.13
barcode08,5,70952114,A,DEL,1124,9,2,7,0.8
barcode08,5,70952117,A,DEL,1120,1,1,0,0.09
barcode08,5,70952118,C,DEL,1117,2,1,1,0.18
barcode08,5,70952119,A,DEL,1099,1,1,0,0.09
barcode08,5,70952120,A,DEL,1103,1,1,0,0.09
barcode08,5,70952121,T,DEL,1099,1,1,0,0.09
barcode08,5,70952122,C,DEL,1070,1,1,0,0.09
barcode08,5,70952123,A,DEL,1068,1,0,1,0.09
barcode08,5,70952127,T,DEL,1056,14,14,0,1.33
barcode08,5,70952128,T,DEL,1054,1,0,1,0.09
barcode08,5,70952129,A,DEL,1053,10,1,9,0.95
barcode08,5,70952132,G,DEL,1046,5,5,0,0.48
barcode08,5,70952133,A,DEL,1042,2,1,1,0.19
barcode08,5,70952134,A,DEL,1041,5,3,2,0.48
barcode08,5,70952135,T,DEL,1034,121,73,48,11.7
barcode08,5,70952136,T,DEL,1033,1,1,0,0.1
barcode08,5,70952139,G,DEL,1024,1,0,1,0.1
barcode08,5,70952140,A,DEL,1025,1,0,1,0.1
barcode08,5,70952143,C,DEL,1024,14,13,1,1.37
barcode08,5,70952144,C,DEL,1021,1,0,1,0.1
barcode08,5,70952145,A,DEL,1014,5,3,2,0.49
barcode08,5,70952150,T,DEL,1001,1,1,0,0.1
barcode08,5,70952151,A,DEL,1000,1,1,0,0.1
barcode08,5,70952152,T,DEL,999,5,5,0,0.5
barcode08,5,70952153,T,DEL,996,1,1,0,0.1
barcode08,5,70952154,A,DEL,976,3,3,0,0.31
barcode08,5,70952155,G,DEL,974,4,4,0,0.41
barcode08,5,70952157,T,DEL,971,2,1,1,0.21
barcode08,5,70952158,A,DEL,960,29,20,9,3.02
barcode08,5,70952164,T,DEL,949,3,3,0,0.32
barcode08,5,70952166,A,DEL,927,1,0,1,0.11
barcode08,5,70952169,C,DEL,902,1,0,1,0.11
barcode08,5,70952170,T,DEL,901,4,0,4,0.44
barcode08,5,70952174,T,DEL,875,1,0,1,0.11
barcode08,5,70952175,C,DEL,869,14,12,2,1.61
barcode08,5,70952178,T,DEL,848,12,1,11,1.42
barcode08,5,70952179,A,DEL,833,6,6,0,0.72
barcode08,5,70952182,A,DEL,786,4,4,0,0.51
barcode08,5,70952183,G,DEL,782,3,3,0,0.38
barcode08,5,70952184,A,DEL,776,1,0,1,0.13
barcode08,5,70952186,T,DEL,767,1,1,0,0.13
barcode08,5,70952189,T,DEL,745,3,1,2,0.4
barcode08,5,70952190,C,DEL,736,1,0,1,0.14
barcode08,5,70952193,A,DEL,711,2,1,1,0.28
barcode08,5,70952194,C,DEL,655,2,2,0,0.31
barcode08,5,70952195,T,DEL,642,3,3,0,0.47
barcode08,5,70952199,C,DEL,554,1,0,1,0.18
barcode08,5,70952200,T,DEL,552,1,0,1,0.18
barcode08,5,70952207,T,DEL,485,1,1,0,0.21
