Patient,Chromosome,Position,Ref_Base,Variant_Type,Total_Depth,DEL_Count,+_Strand,-_Strand,Allele_Frequency(%)
barcode11,5,70921811,T,DEL,1,1,0,1,100.0
barcode11,5,70921812,T,DEL,1,1,0,1,100.0
barcode11,5,70921862,A,DEL,1,1,0,1,100.0
barcode11,5,70921915,G,DEL,1,1,0,1,100.0
barcode11,5,70921995,A,DEL,1,1,0,1,100.0
barcode11,5,70921997,C,DEL,1,1,0,1,100.0
barcode11,5,70924517,T,DEL,2,1,1,0,50.0
barcode11,5,70924525,T,DEL,2,1,1,0,50.0
barcode11,5,70924531,T,DEL,2,1,1,0,50.0
barcode11,5,70924589,G,DEL,2,1,1,0,50.0
barcode11,5,70924595,G,DEL,2,1,1,0,50.0
barcode11,5,70924607,A,DEL,2,1,1,0,50.0
barcode11,5,70924671,A,DEL,2,1,1,0,50.0
barcode11,5,70924697,A,DEL,2,1,1,0,50.0
barcode11,5,70924752,G,DEL,2,1,0,1,50.0
barcode11,5,70924766,G,DEL,2,1,1,0,50.0
barcode11,5,70924847,G,DEL,4,1,1,0,25.0
barcode11,5,70924848,A,DEL,4,1,1,0,25.0
barcode11,5,70924873,A,DEL,2406,639,84,555,26.56
barcode11,5,70924951,G,DEL,4426,1330,197,1133,30.05
barcode11,5,70925075,G,DEL,5099,1207,963,244,23.67
barcode11,5,70925076,C,DEL,5102,1762,1280,482,34.54
barcode11,5,70925077,C,DEL,5130,1061,736,325,20.68
barcode11,5,70925152,G,DEL,4174,926,925,1,22.18
barcode11,5,70925153,A,DEL,4166,948,946,2,22.76
barcode11,5,70925154,T,DEL,4165,1160,1061,99,27.85
barcode11,5,70929310,C,DEL,1,1,0,1,100.0
barcode11,5,70929311,T,DEL,1,1,0,1,100.0
barcode11,5,70929370,C,DEL,1,1,0,1,100.0
barcode11,5,70929403,T,DEL,1,1,0,1,100.0
barcode11,5,70929410,T,DEL,1,1,0,1,100.0
barcode11,5,70929411,T,DEL,1,1,0,1,100.0
barcode11,5,70929412,T,DEL,1,1,0,1,100.0
barcode11,5,70929445,A,DEL,1,1,0,1,100.0
barcode11,5,70929447,T,DEL,1,1,0,1,100.0
barcode11,5,70929476,C,DEL,1,1,0,1,100.0
barcode11,5,70929477,T,DEL,1,1,0,1,100.0
barcode11,5,70929478,C,DEL,1,1,0,1,100.0
barcode11,5,70929482,T,DEL,1,1,0,1,100.0
barcode11,5,70932889,C,DEL,1,1,0,1,100.0
barcode11,5,70932890,C,DEL,1,1,0,1,100.0
barcode11,5,70932891,C,DEL,1,1,0,1,100.0
barcode11,5,70932892,C,DEL,1,1,0,1,100.0
barcode11,5,70932893,G,DEL,1,1,0,1,100.0
barcode11,5,70932894,C,DEL,1,1,0,1,100.0
barcode11,5,70932895,C,DEL,1,1,0,1,100.0
barcode11,5,70932896,C,DEL,1,1,0,1,100.0
barcode11,5,70932897,C,DEL,1,1,0,1,100.0
barcode11,5,70932898,T,DEL,1,1,0,1,100.0
barcode11,5,70932899,G,DEL,1,1,0,1,100.0
barcode11,5,70932903,A,DEL,1,1,0,1,100.0
barcode11,5,70932904,A,DEL,1,1,0,1,100.0
barcode11,5,70932930,G,DEL,1,1,0,1,100.0
barcode11,5,70933001,T,DEL,1,1,0,1,100.0
barcode11,5,70933073,C,DEL,1,1,0,1,100.0
barcode11,5,70933077,C,DEL,1,1,0,1,100.0
barcode11,5,70933082,T,DEL,1,1,0,1,100.0
barcode11,5,70933085,G,DEL,1,1,0,1,100.0
barcode11,5,70933086,A,DEL,1,1,0,1,100.0
barcode11,5,70933099,G,DEL,1,1,0,1,100.0
barcode11,5,70933138,C,DEL,1,1,0,1,100.0
barcode11,5,70933151,C,DEL,1,1,0,1,100.0
barcode11,5,70933160,T,DEL,1,1,0,1,100.0
barcode11,5,70933161,C,DEL,1,1,0,1,100.0
barcode11,5,70933163,T,DEL,1,1,0,1,100.0
barcode11,5,70933164,T,DEL,1,1,0,1,100.0
barcode11,5,70933165,T,DEL,1,1,0,1,100.0
barcode11,5,70933215,T,DEL,1,1,0,1,100.0
barcode11,5,70933229,A,DEL,1,1,0,1,100.0
barcode11,5,70933235,C,DEL,1,1,0,1,100.0
barcode11,5,70933236,T,DEL,1,1,0,1,100.0
barcode11,5,70933261,T,DEL,1,1,0,1,100.0
barcode11,5,70933278,C,DEL,1,1,0,1,100.0
barcode11,5,70933279,T,DEL,1,1,0,1,100.0
barcode11,5,70933280,C,DEL,1,1,0,1,100.0
barcode11,5,70933318,T,DEL,1,1,0,1,100.0
barcode11,5,70933371,C,DEL,1,1,0,1,100.0
barcode11,5,70941368,T,DEL,1576,402,13,389,25.51
barcode11,5,70941384,C,DEL,1905,465,3,462,24.41
barcode11,5,70942392,C,DEL,1519,329,327,2,21.66
barcode11,5,70942402,T,DEL,1547,364,361,3,23.53
barcode11,5,70942407,T,DEL,1562,388,283,105,24.84
barcode11,5,70942438,T,DEL,1971,711,709,2,36.07
barcode11,5,70942439,A,DEL,1972,1230,1211,19,62.37
barcode11,5,70942440,A,DEL,1976,995,988,7,50.35
barcode11,5,70942441,G,DEL,1979,791,782,9,39.97
barcode11,5,70942442,A,DEL,1996,544,543,1,27.25
barcode11,5,70942481,A,DEL,2160,498,489,9,23.06
barcode11,5,70942511,T,DEL,2037,452,432,20,22.19
barcode11,5,70942512,C,DEL,2043,1041,1011,30,50.95
barcode11,5,70942569,A,DEL,1942,559,558,1,28.78
barcode11,5,70942570,A,DEL,1942,460,460,0,23.69
barcode11,5,70942819,T,DEL,1000,219,35,184,21.9
barcode11,5,70942822,T,DEL,987,206,8,198,20.87
barcode11,5,70942823,C,DEL,988,277,8,269,28.04
barcode11,5,70942824,T,DEL,986,269,3,266,27.28
barcode11,5,70942825,C,DEL,990,445,40,405,44.95
barcode11,5,70942826,C,DEL,993,275,3,272,27.69
barcode11,5,70942835,C,DEL,1005,291,220,71,28.96
barcode11,5,70943031,A,DEL,1,1,0,1,100.0
barcode11,5,70943032,A,DEL,1,1,0,1,100.0
barcode11,5,70944760,A,DEL,2071,518,78,440,25.01
barcode11,5,70946051,T,DEL,4614,1284,1087,197,27.83
barcode11,5,70946072,C,DEL,4840,1343,634,709,27.75
barcode11,5,70946084,C,DEL,4896,1055,1046,9,21.55
barcode11,5,70946132,T,DEL,4973,1039,1032,7,20.89
barcode11,5,70946197,T,DEL,5267,1651,1495,156,31.35
barcode11,5,70953145,C,DEL,1,1,1,0,100.0
barcode11,5,70953303,T,DEL,1,1,1,0,100.0
barcode11,5,70953304,G,DEL,1,1,1,0,100.0
barcode11,5,70953445,C,DEL,1,1,1,0,100.0
barcode11,5,70953481,T,DEL,1,1,1,0,100.0
barcode11,5,70955315,A,DEL,1,1,0,1,100.0
barcode11,5,70956015,C,DEL,1,1,0,1,100.0
barcode11,5,70956017,A,DEL,1,1,0,1,100.0
barcode11,5,70956112,A,DEL,1,1,0,1,100.0
barcode11,5,70956122,T,DEL,1,1,0,1,100.0
barcode11,5,70956181,T,DEL,1,1,0,1,100.0
barcode11,5,70956182,C,DEL,1,1,0,1,100.0
barcode11,5,70956259,C,DEL,1,1,0,1,100.0
barcode11,5,70956260,C,DEL,1,1,0,1,100.0
barcode11,5,70956261,C,DEL,1,1,0,1,100.0
barcode11,5,70956277,T,DEL,1,1,0,1,100.0
barcode11,5,70959287,A,DEL,1,1,1,0,100.0
barcode11,5,70959420,A,DEL,1,1,1,0,100.0
barcode11,5,70959421,A,DEL,1,1,1,0,100.0
barcode11,5,70959422,G,DEL,1,1,1,0,100.0
barcode11,5,70959423,A,DEL,1,1,1,0,100.0
barcode14,5,70914490,A,DEL,1,1,1,0,100.0
barcode14,5,70914494,G,DEL,1,1,1,0,100.0
barcode14,5,70914505,T,DEL,1,1,1,0,100.0
barcode14,5,70914532,G,DEL,1,1,1,0,100.0
barcode14,5,70914540,T,DEL,1,1,1,0,100.0
barcode14,5,70924453,G,DEL,5,3,0,3,60.0
barcode14,5,70924454,G,DEL,5,2,0,2,40.0
barcode14,5,70924461,A,DEL,5,2,0,2,40.0
barcode14,5,70924462,A,DEL,5,2,0,2,40.0
barcode14,5,70924471,T,DEL,5,1,0,1,20.0
barcode14,5,70924479,A,DEL,5,2,0,2,40.0
barcode14,5,70924484,T,DEL,5,1,0,1,20.0
barcode14,5,70924485,C,DEL,5,1,0,1,20.0
barcode14,5,70924486,T,DEL,5,1,0,1,20.0
barcode14,5,70924487,G,DEL,5,4,0,4,80.0
barcode14,5,70924488,C,DEL,5,5,0,5,100.0
barcode14,5,70924489,C,DEL,5,5,0,5,100.0
barcode14,5,70924490,G,DEL,5,2,0,2,40.0
barcode14,5,70924491,C,DEL,5,2,0,2,40.0
barcode14,5,70924492,C,DEL,5,1,0,1,20.0
barcode14,5,70924493,T,DEL,5,1,0,1,20.0
barcode14,5,70924494,T,DEL,5,1,0,1,20.0
barcode14,5,70924495,C,DEL,5,1,0,1,20.0
barcode14,5,70924543,A,DEL,8,2,0,2,25.0
barcode14,5,70924554,A,DEL,10,2,0,2,20.0
barcode14,5,70924589,G,DEL,10,7,1,6,70.0
barcode14,5,70924595,G,DEL,11,5,2,3,45.45
barcode14,5,70924600,A,DEL,11,3,0,3,27.27
barcode14,5,70924668,C,DEL,11,3,0,3,27.27
barcode14,5,70924700,A,DEL,13,3,0,3,23.08
barcode14,5,70924752,G,DEL,15,6,0,6,40.0
barcode14,5,70924785,A,DEL,16,5,4,1,31.25
barcode14,5,70924873,A,DEL,866,270,32,238,31.18
barcode14,5,70924951,G,DEL,1545,434,59,375,28.09
barcode14,5,70925075,G,DEL,1799,426,353,73,23.68
barcode14,5,70925076,C,DEL,1799,590,448,142,32.8
barcode14,5,70925077,C,DEL,1815,365,266,99,20.11
barcode14,5,70925152,G,DEL,1546,335,334,1,21.67
barcode14,5,70925153,A,DEL,1542,339,338,1,21.98
barcode14,5,70925154,T,DEL,1542,414,378,36,26.85
barcode14,5,70941368,T,DEL,160,34,1,33,21.25
barcode14,5,70941384,C,DEL,199,56,0,56,28.14
barcode14,5,70942402,T,DEL,416,103,102,1,24.76
barcode14,5,70942407,T,DEL,414,100,77,23,24.15
barcode14,5,70942438,T,DEL,463,169,168,1,36.5
barcode14,5,70942439,A,DEL,462,291,284,7,62.99
barcode14,5,70942440,A,DEL,461,225,220,5,48.81
barcode14,5,70942441,G,DEL,461,175,169,6,37.96
barcode14,5,70942442,A,DEL,471,121,120,1,25.69
barcode14,5,70942481,A,DEL,497,110,105,5,22.13
barcode14,5,70942511,T,DEL,471,99,94,5,21.02
barcode14,5,70942512,C,DEL,471,248,240,8,52.65
barcode14,5,70942569,A,DEL,396,91,91,0,22.98
barcode14,5,70942598,A,DEL,2,1,1,0,50.0
barcode14,5,70942819,T,DEL,305,62,9,53,20.33
barcode14,5,70942822,T,DEL,297,63,1,62,21.21
barcode14,5,70942823,C,DEL,295,83,2,81,28.14
barcode14,5,70942824,T,DEL,295,73,1,72,24.75
barcode14,5,70942825,C,DEL,295,127,16,111,43.05
barcode14,5,70942826,C,DEL,297,76,1,75,25.59
barcode14,5,70942835,C,DEL,290,101,76,25,34.83
barcode14,5,70944760,A,DEL,847,302,16,286,35.66
barcode14,5,70944761,A,DEL,846,173,6,167,20.45
barcode14,5,70946051,T,DEL,636,153,123,30,24.06
barcode14,5,70946072,C,DEL,690,225,83,142,32.61
barcode14,5,70946084,C,DEL,707,149,148,1,21.07
barcode14,5,70946099,T,DEL,697,145,7,138,20.8
barcode14,5,70946100,C,DEL,696,153,13,140,21.98
barcode14,5,70946132,T,DEL,728,155,154,1,21.29
barcode14,5,70946197,T,DEL,829,252,230,22,30.4
barcode14,5,70952085,C,DEL,1238,270,244,26,21.81
barcode12,5,70924554,A,DEL,1,1,0,1,100.0
barcode12,5,70924564,T,DEL,1,1,0,1,100.0
barcode12,5,70924873,A,DEL,1085,312,34,278,28.76
barcode12,5,70924951,G,DEL,2127,569,89,480,26.75
barcode12,5,70925075,G,DEL,2380,552,438,114,23.19
barcode12,5,70925076,C,DEL,2376,770,566,204,32.41
barcode12,5,70925077,C,DEL,2390,500,346,154,20.92
barcode12,5,70925154,T,DEL,1891,506,452,54,26.76
barcode12,5,70941368,T,DEL,263,63,4,59,23.95
barcode12,5,70941384,C,DEL,332,89,1,88,26.81
barcode12,5,70942392,C,DEL,1015,261,259,2,25.71
barcode12,5,70942402,T,DEL,1026,240,240,0,23.39
barcode12,5,70942407,T,DEL,1032,241,193,48,23.35
barcode12,5,70942438,T,DEL,1138,414,411,3,36.38
barcode12,5,70942439,A,DEL,1142,717,706,11,62.78
barcode12,5,70942440,A,DEL,1144,563,559,4,49.21
barcode12,5,70942441,G,DEL,1146,442,437,5,38.57
barcode12,5,70942442,A,DEL,1154,296,296,0,25.65
barcode12,5,70942481,A,DEL,1230,288,283,5,23.41
barcode12,5,70942511,T,DEL,1207,257,254,3,21.29
barcode12,5,70942512,C,DEL,1207,632,626,6,52.36
barcode12,5,70942569,A,DEL,1132,322,321,1,28.45
barcode12,5,70942570,A,DEL,1129,261,260,1,23.12
barcode12,5,70942600,A,DEL,2,1,1,0,50.0
barcode12,5,70942601,G,DEL,2,1,1,0,50.0
barcode12,5,70942602,A,DEL,2,1,1,0,50.0
barcode12,5,70942603,C,DEL,2,1,1,0,50.0
barcode12,5,70942604,T,DEL,2,1,1,0,50.0
barcode12,5,70942823,C,DEL,591,149,2,147,25.21
barcode12,5,70942824,T,DEL,593,135,0,135,22.77
barcode12,5,70942825,C,DEL,598,241,32,209,40.3
barcode12,5,70942826,C,DEL,603,135,0,135,22.39
barcode12,5,70942835,C,DEL,602,189,151,38,31.4
barcode12,5,70944760,A,DEL,1233,309,42,267,25.06
barcode12,5,70946051,T,DEL,1875,389,304,85,20.75
barcode12,5,70946072,C,DEL,1986,565,184,381,28.45
barcode12,5,70946099,T,DEL,1997,433,15,418,21.68
barcode12,5,70946100,C,DEL,1996,465,38,427,23.3
barcode12,5,70946197,T,DEL,2436,717,646,71,29.43
barcode09,5,70924873,A,DEL,1537,436,58,378,28.37
barcode09,5,70924951,G,DEL,3019,888,139,749,29.41
barcode09,5,70925075,G,DEL,3615,864,714,150,23.9
barcode09,5,70925076,C,DEL,3612,1213,910,303,33.58
barcode09,5,70925077,C,DEL,3621,769,567,202,21.24
barcode09,5,70925152,G,DEL,2974,629,629,0,21.15
barcode09,5,70925153,A,DEL,2964,646,643,3,21.79
barcode09,5,70925154,T,DEL,2961,805,737,68,27.19
barcode09,5,70941368,T,DEL,730,198,6,192,27.12
barcode09,5,70941384,C,DEL,862,243,0,243,28.19
barcode09,5,70941553,A,DEL,1,1,0,1,100.0
barcode09,5,70942402,T,DEL,674,138,137,1,20.47
barcode09,5,70942407,T,DEL,681,178,122,56,26.14
barcode09,5,70942438,T,DEL,798,228,228,0,28.57
barcode09,5,70942439,A,DEL,795,455,438,17,57.23
barcode09,5,70942440,A,DEL,796,342,340,2,42.96
barcode09,5,70942441,G,DEL,796,266,262,4,33.42
barcode09,5,70942442,A,DEL,802,184,184,0,22.94
barcode09,5,70942481,A,DEL,859,186,176,10,21.65
barcode09,5,70942511,T,DEL,824,167,157,10,20.27
barcode09,5,70942512,C,DEL,825,385,370,15,46.67
barcode09,5,70942569,A,DEL,703,191,191,0,27.17
barcode09,5,70942570,A,DEL,700,158,158,0,22.57
barcode09,5,70942822,T,DEL,258,54,0,54,20.93
barcode09,5,70942823,C,DEL,258,71,1,70,27.52
barcode09,5,70942824,T,DEL,259,64,2,62,24.71
barcode09,5,70942825,C,DEL,264,96,15,81,36.36
barcode09,5,70942826,C,DEL,265,58,1,57,21.89
barcode09,5,70942835,C,DEL,258,71,64,7,27.52
barcode09,5,70944760,A,DEL,616,157,19,138,25.49
barcode09,5,70946051,T,DEL,1127,264,207,57,23.43
barcode09,5,70946072,C,DEL,1190,350,117,233,29.41
barcode09,5,70946099,T,DEL,1193,279,9,270,23.39
barcode09,5,70946100,C,DEL,1196,294,16,278,24.58
barcode09,5,70946197,T,DEL,1415,428,390,38,30.25
barcode09,5,70951929,T,DEL,4,1,1,0,25.0
barcode15,5,70914905,A,DEL,1,1,0,1,100.0
barcode15,5,70914906,C,DEL,1,1,0,1,100.0
barcode15,5,70914907,T,DEL,1,1,0,1,100.0
barcode15,5,70914908,C,DEL,1,1,0,1,100.0
barcode15,5,70924785,A,DEL,1,1,1,0,100.0
barcode15,5,70924873,A,DEL,530,176,3,173,33.21
barcode15,5,70924951,G,DEL,896,276,28,248,30.8
barcode15,5,70925020,T,DEL,1013,209,6,203,20.63
barcode15,5,70925075,G,DEL,972,224,177,47,23.05
barcode15,5,70925076,C,DEL,971,335,228,107,34.5
barcode15,5,70925077,C,DEL,975,219,148,71,22.46
barcode15,5,70925147,A,DEL,852,171,171,0,20.07
barcode15,5,70925152,G,DEL,844,195,195,0,23.1
barcode15,5,70925153,A,DEL,842,204,204,0,24.23
barcode15,5,70925154,T,DEL,842,283,262,21,33.61
barcode15,5,70930611,C,DEL,1,1,0,1,100.0
barcode15,5,70930676,T,DEL,1,1,0,1,100.0
barcode15,5,70930677,C,DEL,1,1,0,1,100.0
barcode15,5,70930678,G,DEL,1,1,0,1,100.0
barcode15,5,70930679,C,DEL,1,1,0,1,100.0
barcode15,5,70930686,C,DEL,1,1,0,1,100.0
barcode15,5,70930687,C,DEL,1,1,0,1,100.0
barcode15,5,70930688,A,DEL,1,1,0,1,100.0
barcode15,5,70940084,T,DEL,1,1,1,0,100.0
barcode15,5,70940091,C,DEL,1,1,1,0,100.0
barcode15,5,70941368,T,DEL,296,69,2,67,23.31
barcode15,5,70941384,C,DEL,365,79,0,79,21.64
barcode15,5,70942402,T,DEL,323,97,97,0,30.03
barcode15,5,70942407,T,DEL,324,97,74,23,29.94
barcode15,5,70942438,T,DEL,386,149,149,0,38.6
barcode15,5,70942439,A,DEL,386,257,254,3,66.58
barcode15,5,70942440,A,DEL,388,215,215,0,55.41
barcode15,5,70942441,G,DEL,388,162,162,0,41.75
barcode15,5,70942442,A,DEL,392,102,102,0,26.02
barcode15,5,70942481,A,DEL,430,104,102,2,24.19
barcode15,5,70942500,C,DEL,418,87,84,3,20.81
barcode15,5,70942511,T,DEL,421,103,99,4,24.47
barcode15,5,70942512,C,DEL,421,233,225,8,55.34
barcode15,5,70942569,A,DEL,417,105,104,1,25.18
barcode15,5,70942570,A,DEL,417,86,85,1,20.62
barcode15,5,70942599,G,DEL,2,1,1,0,50.0
barcode15,5,70942819,T,DEL,421,86,19,67,20.43
barcode15,5,70942822,T,DEL,418,94,1,93,22.49
barcode15,5,70942823,C,DEL,419,124,2,122,29.59
barcode15,5,70942824,T,DEL,419,111,2,109,26.49
barcode15,5,70942825,C,DEL,424,179,22,157,42.22
barcode15,5,70942826,C,DEL,429,111,1,110,25.87
barcode15,5,70942835,C,DEL,432,135,98,37,31.25
barcode15,5,70944760,A,DEL,426,108,12,96,25.35
barcode15,5,70946051,T,DEL,710,220,194,26,30.99
barcode15,5,70946072,C,DEL,752,231,121,110,30.72
barcode15,5,70946084,C,DEL,770,182,181,1,23.64
barcode15,5,70946132,T,DEL,817,224,223,1,27.42
barcode15,5,70946197,T,DEL,968,296,273,23,30.58
barcode15,5,70946940,T,DEL,1,1,1,0,100.0
barcode15,5,70946941,A,DEL,1,1,1,0,100.0
barcode15,5,70947205,A,DEL,1,1,1,0,100.0
barcode15,5,70951929,T,DEL,1,1,1,0,100.0
barcode15,5,70951951,A,DEL,659,132,7,125,20.03
barcode15,5,70958867,A,DEL,1,1,0,1,100.0
barcode15,5,70958881,T,DEL,2,1,0,1,50.0
barcode15,5,70958886,C,DEL,2,1,0,1,50.0
barcode15,5,70958916,A,DEL,2,1,0,1,50.0
barcode15,5,70958998,A,DEL,2,1,0,1,50.0
barcode15,5,70959004,C,DEL,2,1,0,1,50.0
barcode15,5,70959005,C,DEL,2,1,0,1,50.0
barcode15,5,70959023,T,DEL,2,1,0,1,50.0
barcode15,5,70959034,A,DEL,2,1,0,1,50.0
barcode15,5,70959046,C,DEL,2,1,0,1,50.0
barcode15,5,70959066,C,DEL,2,1,0,1,50.0
barcode15,5,70959080,G,DEL,1,1,0,1,100.0
barcode15,5,70959111,A,DEL,1,1,0,1,100.0
barcode15,5,70959149,C,DEL,1,1,0,1,100.0
barcode15,5,70959150,G,DEL,1,1,0,1,100.0
barcode15,5,70959151,C,DEL,1,1,0,1,100.0
barcode15,5,70959152,A,DEL,1,1,0,1,100.0
barcode15,5,70959154,G,DEL,1,1,0,1,100.0
barcode15,5,70959178,T,DEL,1,1,0,1,100.0
barcode15,5,70959185,T,DEL,1,1,0,1,100.0
barcode15,5,70959304,C,DEL,1,1,0,1,100.0
barcode15,5,70959359,A,DEL,1,1,0,1,100.0
barcode10,5,70924873,A,DEL,271,64,4,60,23.62
barcode10,5,70924951,G,DEL,611,168,35,133,27.5
barcode10,5,70925027,C,DEL,800,164,155,9,20.5
barcode10,5,70925075,G,DEL,781,222,191,31,28.43
barcode10,5,70925076,C,DEL,779,304,232,72,39.02
barcode10,5,70925077,C,DEL,780,178,128,50,22.82
barcode10,5,70925152,G,DEL,690,150,150,0,21.74
barcode10,5,70925153,A,DEL,690,156,156,0,22.61
barcode10,5,70925154,T,DEL,689,212,199,13,30.77
barcode10,5,70941368,T,DEL,426,114,3,111,26.76
barcode10,5,70941384,C,DEL,520,157,0,157,30.19
barcode10,5,70942386,T,DEL,633,133,132,1,21.01
barcode10,5,70942402,T,DEL,661,144,141,3,21.79
barcode10,5,70942407,T,DEL,665,142,91,51,21.35
barcode10,5,70942438,T,DEL,766,289,286,3,37.73
barcode10,5,70942439,A,DEL,768,488,481,7,63.54
barcode10,5,70942440,A,DEL,768,402,401,1,52.34
barcode10,5,70942441,G,DEL,769,326,323,3,42.39
barcode10,5,70942442,A,DEL,775,209,208,1,26.97
barcode10,5,70942481,A,DEL,801,188,185,3,23.47
barcode10,5,70942500,C,DEL,766,169,159,10,22.06
barcode10,5,70942512,C,DEL,768,392,377,15,51.04
barcode10,5,70942569,A,DEL,644,189,189,0,29.35
barcode10,5,70942570,A,DEL,643,152,152,0,23.64
barcode10,5,70942819,T,DEL,367,81,14,67,22.07
barcode10,5,70942823,C,DEL,367,89,4,85,24.25
barcode10,5,70942824,T,DEL,370,83,1,82,22.43
barcode10,5,70942825,C,DEL,372,143,19,124,38.44
barcode10,5,70942826,C,DEL,374,85,1,84,22.73
barcode10,5,70942835,C,DEL,395,132,104,28,33.42
barcode10,5,70944760,A,DEL,818,215,26,189,26.28
barcode10,5,70946051,T,DEL,1665,345,266,79,20.72
barcode10,5,70946072,C,DEL,1747,522,160,362,29.88
barcode10,5,70946099,T,DEL,1768,413,14,399,23.36
barcode10,5,70946100,C,DEL,1769,440,29,411,24.87
barcode10,5,70946197,T,DEL,2037,631,556,75,30.98
barcode10,5,70951929,T,DEL,5,1,1,0,20.0
barcode13,5,70924873,A,DEL,972,308,30,278,31.69
barcode13,5,70924951,G,DEL,1667,446,71,375,26.75
barcode13,5,70925020,T,DEL,1911,400,20,380,20.93
barcode13,5,70925075,G,DEL,1715,434,351,83,25.31
barcode13,5,70925076,C,DEL,1715,599,450,149,34.93
barcode13,5,70925077,C,DEL,1769,386,300,86,21.82
barcode13,5,70925152,G,DEL,1623,367,366,1,22.61
barcode13,5,70925153,A,DEL,1618,379,379,0,23.42
barcode13,5,70925154,T,DEL,1619,476,442,34,29.4
barcode13,5,70941368,T,DEL,515,130,3,127,25.24
barcode13,5,70941384,C,DEL,614,164,0,164,26.71
barcode13,5,70942402,T,DEL,796,204,204,0,25.63
barcode13,5,70942407,T,DEL,796,194,161,33,24.37
barcode13,5,70942438,T,DEL,872,351,351,0,40.25
barcode13,5,70942439,A,DEL,874,606,600,6,69.34
barcode13,5,70942440,A,DEL,876,484,482,2,55.25
barcode13,5,70942441,G,DEL,875,377,374,3,43.09
barcode13,5,70942442,A,DEL,881,235,235,0,26.67
barcode13,5,70942481,A,DEL,953,242,237,5,25.39
barcode13,5,70942500,C,DEL,928,193,190,3,20.8
barcode13,5,70942511,T,DEL,925,199,193,6,21.51
barcode13,5,70942512,C,DEL,926,457,451,6,49.35
barcode13,5,70942569,A,DEL,826,231,231,0,27.97
barcode13,5,70942570,A,DEL,825,183,183,0,22.18
barcode13,5,70942819,T,DEL,407,86,7,79,21.13
barcode13,5,70942822,T,DEL,393,96,4,92,24.43
barcode13,5,70942823,C,DEL,391,124,6,118,31.71
barcode13,5,70942824,T,DEL,389,115,4,111,29.56
barcode13,5,70942825,C,DEL,391,175,14,161,44.76
barcode13,5,70942826,C,DEL,396,114,1,113,28.79
barcode13,5,70942835,C,DEL,399,105,80,25,26.32
barcode13,5,70944760,A,DEL,672,182,29,153,27.08
barcode13,5,70946051,T,DEL,951,223,177,46,23.45
barcode13,5,70946072,C,DEL,1057,339,129,210,32.07
barcode13,5,70946100,C,DEL,1114,235,15,220,21.1
barcode13,5,70946197,T,DEL,1428,442,402,40,30.95
barcode13,5,70951957,A,DEL,979,196,52,144,20.02
barcode13,5,70952085,C,DEL,1905,447,406,41,23.46
barcode08,5,70924873,A,DEL,442,105,13,92,23.76
barcode08,5,70924951,G,DEL,841,226,29,197,26.87
barcode08,5,70925075,G,DEL,1002,245,201,44,24.45
barcode08,5,70925076,C,DEL,1001,333,244,89,33.27
barcode08,5,70925077,C,DEL,1013,212,153,59,20.93
barcode08,5,70925152,G,DEL,834,170,170,0,20.38
barcode08,5,70925153,A,DEL,834,177,175,2,21.22
barcode08,5,70925154,T,DEL,834,232,215,17,27.82
barcode08,5,70937534,A,DEL,1,1,0,1,100.0
barcode08,5,70938753,G,DEL,5,1,1,0,20.0
barcode08,5,70941368,T,DEL,181,62,2,60,34.25
barcode08,5,70941384,C,DEL,219,61,1,60,27.85
barcode08,5,70942407,T,DEL,313,76,47,29,24.28
barcode08,5,70942438,T,DEL,336,96,96,0,28.57
barcode08,5,70942439,A,DEL,336,172,163,9,51.19
barcode08,5,70942440,A,DEL,336,132,130,2,39.29
barcode08,5,70942441,G,DEL,337,113,111,2,33.53
barcode08,5,70942481,A,DEL,342,76,73,3,22.22
barcode08,5,70942512,C,DEL,324,156,155,1,48.15
barcode08,5,70942569,A,DEL,250,64,63,1,25.6
barcode08,5,70942819,T,DEL,227,48,9,39,21.15
barcode08,5,70942823,C,DEL,227,59,0,59,25.99
barcode08,5,70942824,T,DEL,227,57,1,56,25.11
barcode08,5,70942825,C,DEL,228,91,15,76,39.91
barcode08,5,70942826,C,DEL,228,55,0,55,24.12
barcode08,5,70942835,C,DEL,225,67,53,14,29.78
barcode08,5,70944760,A,DEL,605,141,19,122,23.31
barcode08,5,70946051,T,DEL,1116,238,181,57,21.33
barcode08,5,70946072,C,DEL,1208,403,131,272,33.36
barcode08,5,70946099,T,DEL,1239,282,10,272,22.76
barcode08,5,70946100,C,DEL,1237,294,11,283,23.77
barcode08,5,70946197,T,DEL,1343,409,358,51,30.45
barcode08,5,70946323,C,DEL,4,1,0,1,25.0
