Patient,Chromosome,Position,Ref_Base,Variant_Type,Total_Depth,DEL_Count,+_Strand,-_Strand,Allele_Frequency(%)
barcode11,5,70921811,T,DEL,1,1,0,1,100.0
barcode11,5,70921812,T,DEL,1,1,0,1,100.0
barcode11,5,70921862,A,DEL,1,1,0,1,100.0
barcode11,5,70921997,C,DEL,1,1,0,1,100.0
barcode11,5,70924517,T,DEL,2,1,1,0,50.0
barcode11,5,70924525,T,DEL,2,1,1,0,50.0
barcode11,5,70924752,G,DEL,2,1,0,1,50.0
barcode11,5,70924766,G,DEL,2,1,1,0,50.0
barcode11,5,70924873,A,DEL,2406,626,73,553,26.02
barcode11,5,70924951,G,DEL,4426,1096,90,1006,24.76
barcode11,5,70929410,T,DEL,1,1,0,1,100.0
barcode11,5,70929411,T,DEL,1,1,0,1,100.0
barcode11,5,70929412,T,DEL,1,1,0,1,100.0
barcode11,5,70929482,T,DEL,1,1,0,1,100.0
barcode11,5,70941368,T,DEL,1576,373,11,362,23.67
barcode11,5,70942512,C,DEL,2043,771,745,26,37.74
barcode11,5,70942835,C,DEL,1005,232,168,64,23.08
barcode11,5,70943031,A,DEL,1,1,0,1,100.0
barcode11,5,70943032,A,DEL,1,1,0,1,100.0
barcode11,5,70944760,A,DEL,2071,463,27,436,22.36
barcode11,5,70946197,T,DEL,5267,1302,1172,130,24.72
barcode11,5,70953445,C,DEL,1,1,1,0,100.0
barcode11,5,70953481,T,DEL,1,1,1,0,100.0
barcode11,5,70955315,A,DEL,1,1,0,1,100.0
barcode11,5,70956017,A,DEL,1,1,0,1,100.0
barcode11,5,70956122,T,DEL,1,1,0,1,100.0
barcode11,5,70956259,C,DEL,1,1,0,1,100.0
barcode11,5,70956260,C,DEL,1,1,0,1,100.0
barcode11,5,70956261,C,DEL,1,1,0,1,100.0
barcode11,5,70956277,T,DEL,1,1,0,1,100.0
barcode14,5,70924453,G,DEL,5,2,0,2,40.0
barcode14,5,70924454,G,DEL,5,1,0,1,20.0
barcode14,5,70924479,A,DEL,5,1,0,1,20.0
barcode14,5,70924484,T,DEL,5,1,0,1,20.0
barcode14,5,70924485,C,DEL,5,1,0,1,20.0
barcode14,5,70924486,T,DEL,5,1,0,1,20.0
barcode14,5,70924487,G,DEL,5,4,0,4,80.0
barcode14,5,70924488,C,DEL,5,5,0,5,100.0
barcode14,5,70924489,C,DEL,5,5,0,5,100.0
barcode14,5,70924490,G,DEL,5,2,0,2,40.0
barcode14,5,70924491,C,DEL,5,2,0,2,40.0
barcode14,5,70924492,C,DEL,5,1,0,1,20.0
barcode14,5,70924493,T,DEL,5,1,0,1,20.0
barcode14,5,70924494,T,DEL,5,1,0,1,20.0
barcode14,5,70924554,A,DEL,10,2,0,2,20.0
barcode14,5,70924589,G,DEL,10,7,1,6,70.0
barcode14,5,70924595,G,DEL,11,4,1,3,36.36
barcode14,5,70924700,A,DEL,13,3,0,3,23.08
barcode14,5,70924752,G,DEL,15,5,0,5,33.33
barcode14,5,70924785,A,DEL,16,4,3,1,25.0
barcode14,5,70924873,A,DEL,866,266,30,236,30.72
barcode14,5,70924951,G,DEL,1545,357,23,334,23.11
barcode14,5,70942512,C,DEL,471,189,181,8,40.13
barcode14,5,70942825,C,DEL,295,59,13,46,20.0
barcode14,5,70942835,C,DEL,290,88,64,24,30.34
barcode14,5,70944760,A,DEL,847,289,4,285,34.12
barcode14,5,70946072,C,DEL,690,151,44,107,21.88
barcode14,5,70946197,T,DEL,829,199,182,17,24.0
barcode12,5,70924554,A,DEL,1,1,0,1,100.0
barcode12,5,70924564,T,DEL,1,1,0,1,100.0
barcode12,5,70924873,A,DEL,1085,301,26,275,27.74
barcode12,5,70924951,G,DEL,2127,466,44,422,21.91
barcode12,5,70941368,T,DEL,263,57,1,56,21.67
barcode12,5,70942512,C,DEL,1207,496,490,6,41.09
barcode12,5,70942835,C,DEL,602,163,126,37,27.08
barcode12,5,70944760,A,DEL,1233,276,15,261,22.38
barcode12,5,70946197,T,DEL,2436,579,521,58,23.77
barcode09,5,70924873,A,DEL,1537,425,48,377,27.65
barcode09,5,70924951,G,DEL,3019,718,51,667,23.78
barcode09,5,70941368,T,DEL,730,190,4,186,26.03
barcode09,5,70942512,C,DEL,825,295,282,13,35.76
barcode09,5,70942835,C,DEL,258,58,51,7,22.48
barcode09,5,70944760,A,DEL,616,144,6,138,23.38
barcode09,5,70946072,C,DEL,1190,242,59,183,20.34
barcode09,5,70946197,T,DEL,1415,318,291,27,22.47
barcode09,5,70951929,T,DEL,4,1,1,0,25.0
barcode15,5,70924785,A,DEL,1,1,1,0,100.0
barcode15,5,70924873,A,DEL,530,174,2,172,32.83
barcode15,5,70924951,G,DEL,896,235,13,222,26.23
barcode15,5,70940084,T,DEL,1,1,1,0,100.0
barcode15,5,70941368,T,DEL,296,66,2,64,22.3
barcode15,5,70942512,C,DEL,421,175,168,7,41.57
barcode15,5,70942835,C,DEL,432,113,80,33,26.16
barcode15,5,70944760,A,DEL,426,99,3,96,23.24
barcode15,5,70946051,T,DEL,710,152,133,19,21.41
barcode15,5,70946072,C,DEL,752,166,74,92,22.07
barcode15,5,70946084,C,DEL,770,164,163,1,21.3
barcode15,5,70946197,T,DEL,968,227,206,21,23.45
barcode15,5,70951929,T,DEL,1,1,1,0,100.0
barcode10,5,70924873,A,DEL,271,63,3,60,23.25
barcode10,5,70924951,G,DEL,611,139,15,124,22.75
barcode10,5,70941368,T,DEL,426,103,1,102,24.18
barcode10,5,70942512,C,DEL,768,309,296,13,40.23
barcode10,5,70942835,C,DEL,395,108,84,24,27.34
barcode10,5,70944760,A,DEL,818,199,12,187,24.33
barcode10,5,70946072,C,DEL,1747,360,77,283,20.61
barcode10,5,70946197,T,DEL,2037,475,412,63,23.32
barcode10,5,70951929,T,DEL,5,1,1,0,20.0
barcode13,5,70924873,A,DEL,972,303,27,276,31.17
barcode13,5,70924951,G,DEL,1667,358,28,330,21.48
barcode13,5,70941368,T,DEL,515,121,3,118,23.5
barcode13,5,70942512,C,DEL,926,371,367,4,40.06
barcode13,5,70942835,C,DEL,399,88,63,25,22.06
barcode13,5,70944760,A,DEL,672,160,9,151,23.81
barcode13,5,70946072,C,DEL,1057,244,73,171,23.08
barcode13,5,70946197,T,DEL,1428,336,303,33,23.53
barcode08,5,70924873,A,DEL,442,103,11,92,23.3
barcode08,5,70924951,G,DEL,841,177,9,168,21.05
barcode08,5,70941368,T,DEL,181,52,1,51,28.73
barcode08,5,70942512,C,DEL,324,123,122,1,37.96
barcode08,5,70942835,C,DEL,225,58,44,14,25.78
barcode08,5,70944760,A,DEL,605,125,4,121,20.66
barcode08,5,70946072,C,DEL,1208,281,77,204,23.26
barcode08,5,70946197,T,DEL,1343,321,284,37,23.9
